Book,Time,Action,Bonus,Change,Balance
Draftkings,2021-11-07 10:00:00,Deposit,,150.0,150.0
Draftkings,2021-11-07 10:03:00,Wager,,-5.0,145.0
Draftkings,2021-11-07 20:19:00,Wager,,-10.0,135.0
Draftkings,2021-11-08 13:27:00,Wager,,-7.0,128.0
Draftkings,2021-11-08 18:50:00,Wager,,-10.0,118.0
Draftkings,2021-11-08 23:48:00,Winnings,,23.45,141.45
Draftkings,2021-11-08 23:48:00,Winnings,,8.22,149.67
Draftkings,2021-11-08 23:49:00,Winnings,Bonus,1.0,150.67
Draftkings,2021-11-09 00:26:00,Winnings,,36.0,186.67
Draftkings,2021-11-09 18:52:00,Wager,,-0.67,186.0
Draftkings,2021-11-09 19:23:00,Wager,,-10.0,176.0
Draftkings,2021-11-10 00:11:00,Winnings,,71.42,247.42
Draftkings,2021-11-10 00:11:00,Winnings,Bonus,1.0,248.42
Draftkings,2021-11-10 00:11:00,Winnings,Bonus,1.0,249.42
Draftkings,2021-11-10 00:11:00,Winnings,Bonus,1.0,250.42
Draftkings,2021-11-10 00:11:00,Winnings,Bonus,1.0,251.42
Draftkings,2021-11-10 00:17:00,Winnings,,0.67,254.1
Draftkings,2021-11-10 00:17:00,Winnings,,2.01,253.43
Draftkings,2021-11-10 17:38:00,Wager,,-10.0,244.1
Draftkings,2021-11-10 22:19:00,Winnings,,16.06,260.16
Draftkings,2021-11-10 22:19:00,Winnings,,3.03,263.19
Draftkings,2021-11-10 22:31:00,Winnings,Bonus,1.0,264.19
Draftkings,2021-11-11 12:25:00,Wager,,-10.0,254.19
Draftkings,2021-11-12 18:30:00,Wager,,-1.19,253.0
Draftkings,2021-11-12 20:03:00,Wager,,-2.0,251.0
Draftkings,2021-11-12 22:38:00,Winnings,Bonus,1.0,252.0
Draftkings,2021-11-13 12:24:00,Wager,,-10.0,242.0
Draftkings,2021-11-13 12:26:00,Wager,,-2.0,240.0
Draftkings,2021-11-13 19:04:00,Winnings,Bonus,1.0,241.0
Draftkings,2021-11-14 10:47:00,Wager,,-2.0,239.0
Draftkings,2021-11-14 12:50:00,Wager,,-5.0,234.0
Draftkings,2021-11-14 13:35:00,Winnings,,7.85,241.85
Draftkings,2021-11-14 13:35:00,Winnings,,2.15,244.0
Draftkings,2021-11-14 16:06:00,Winnings,Bonus,1.0,248.0
Draftkings,2021-11-14 16:06:00,Winnings,Bonus,1.0,247.0
Draftkings,2021-11-14 16:06:00,Winnings,Bonus,1.0,245.0
Draftkings,2021-11-14 16:06:00,Winnings,Bonus,1.0,246.0
Draftkings,2021-11-14 17:03:00,Wager,,-10.0,238.0
Draftkings,2021-11-14 17:15:00,Winnings,Bonus,1.0,239.0
Draftkings,2021-11-14 19:22:00,Winnings,Bonus,1.0,240.0
Draftkings,2021-11-14 19:43:00,Wager,,-5.0,235.0
Draftkings,2021-11-14 19:48:00,Wager,,-1.0,234.0
Draftkings,2021-11-15 15:53:00,Wager,,-14.0,220.0
Draftkings,2021-11-15 23:10:00,Winnings,Bonus,1.0,221.0
Draftkings,2021-11-16 19:58:00,Wager,,-1.0,220.0
Draftkings,2021-11-17 16:23:00,Wager,,-5.0,215.0
Draftkings,2021-11-18 23:43:00,Wager,,-5.0,210.0
Draftkings,2021-11-28 20:17:00,Wager,,-10.0,200.0
Draftkings,2021-11-29 00:13:00,Winnings,Bonus,1.0,201.0
Draftkings,2021-11-29 14:01:00,Wager,,-10.0,191.0
Draftkings,2021-11-29 14:02:00,Wager,,-1.0,190.0
Draftkings,2021-11-30 10:26:00,Wager,,-2.0,188.0
Draftkings,2021-11-30 18:39:00,Wager,,-12.0,176.0
Draftkings,2021-11-30 18:41:00,Wager,,-6.0,170.0
Draftkings,2021-11-30 21:29:00,Winnings,,9.52,179.52
Draftkings,2021-11-30 21:32:00,Winnings,Bonus,1.0,180.52
Draftkings,2021-11-30 23:45:00,Winnings,,13.29,193.81
Draftkings,2021-11-30 23:46:00,Winnings,,3.73,197.54
Draftkings,2021-12-01 00:20:00,Winnings,,17.45,214.99
Draftkings,2021-12-01 00:20:00,Winnings,,2.73,217.72
Draftkings,2021-12-01 00:21:00,Winnings,,11.45,229.17
Draftkings,2021-12-01 00:21:00,Winnings,,1.36,230.53
Draftkings,2021-12-01 00:23:00,Winnings,Bonus,1.0,231.53
Draftkings,2021-12-01 18:29:00,Wager,,-10.0,221.53
Draftkings,2021-12-01 21:19:00,Winnings,,5.5,248.03
Draftkings,2021-12-01 21:19:00,Winnings,,21.0,242.53
Draftkings,2021-12-02 19:58:00,Wager,,-10.0,238.03
Draftkings,2021-12-03 15:44:00,Wager,,-50.0,188.03
Draftkings,2021-12-03 23:39:00,Winnings,Bonus,1.0,189.03
Draftkings,2021-12-03 23:39:00,Winnings,Bonus,1.0,190.03
Draftkings,2021-12-04 12:02:00,Wager,,-13.0,177.03
Draftkings,2021-12-04 12:03:00,Wager,,-2.03,175.0
Draftkings,2021-12-04 12:07:00,Wager,,-10.0,165.0
Draftkings,2021-12-04 19:03:00,Winnings,Bonus,1.0,166.0
Draftkings,2021-12-05 14:43:00,Wager,,-0.5,165.5
Draftkings,2021-12-05 15:58:00,Winnings,Bonus,1.0,166.5
Draftkings,2021-12-05 19:37:00,Winnings,Bonus,1.0,167.5
Draftkings,2021-12-05 21:07:00,Wager,,-1.5,166.0
Draftkings,2021-12-05 23:16:00,Winnings,Bonus,1.0,197.5
Draftkings,2021-12-05 23:16:00,Winnings,,8.69,196.5
Draftkings,2021-12-05 23:16:00,Winnings,,21.81,187.81
Draftkings,2021-12-06 19:01:00,Wager,,-5.0,192.5
Draftkings,2021-12-06 19:18:00,Wager,,-2.0,190.5
Draftkings,2021-12-06 20:40:00,Winnings,,5.0,195.5
Draftkings,2021-12-06 20:40:00,Winnings,,0.99,196.49
Draftkings,2021-12-06 21:22:00,Winnings,Bonus,1.0,197.49
Draftkings,2021-12-07 18:49:00,Wager,,-12.0,185.49
Draftkings,2021-12-07 21:55:00,Winnings,,22.43,207.92
Draftkings,2021-12-07 21:56:00,Winnings,,5.22,213.14
Draftkings,2021-12-08 17:27:00,Wager,,-1.14,212.0
Draftkings,2021-12-08 19:19:00,Wager,,-1.0,211.0
Draftkings,2021-12-09 14:23:00,Wager,,-9.0,202.0
Draftkings,2021-12-09 20:28:00,Winnings,,13.28,215.28
Draftkings,2021-12-09 20:29:00,Winnings,,3.91,219.19
Draftkings,2021-12-09 22:40:00,Winnings,Bonus,1.0,220.19
Draftkings,2021-12-12 12:52:00,Wager,,-1.0,219.19
Draftkings,2021-12-12 12:56:00,Wager,,-7.0,212.19
Draftkings,2021-12-14 14:47:00,Wager,,-12.19,200.0
Draftkings,2021-12-15 00:44:00,Winnings,,23.27,223.27
Draftkings,2021-12-15 00:44:00,Winnings,,5.54,228.81
Draftkings,2021-12-15 00:46:00,Winnings,Bonus,1.0,229.81
Draftkings,2021-12-16 10:56:00,Wager,,-17.0,212.81
Draftkings,2021-12-20 23:21:00,Winnings,Bonus,1.0,213.81
Draftkings,2022-01-09 10:04:00,Wager,,-7.0,206.81
Draftkings,2022-01-09 18:58:00,Winnings,Bonus,1.0,207.81
Draftkings,2022-01-09 23:58:00,Wager,,-10.0,197.81
Draftkings,2022-01-10 00:05:00,Winnings,,23.5,221.31
Draftkings,2022-01-10 17:46:00,Wager,,-10.0,211.31
Draftkings,2022-01-10 23:58:00,Winnings,,28.0,239.31
Draftkings,2022-01-11 00:00:00,Winnings,,4.5,243.81
Draftkings,2022-01-11 00:01:00,Winnings,Bonus,1.0,244.81
Draftkings,2022-01-12 17:14:00,Wager,,-5.0,239.81
Draftkings,2022-01-12 17:14:00,Wager,,-5.0,234.81
Draftkings,2022-01-12 17:17:00,Wager,,-5.0,229.81
Draftkings,2022-01-12 20:54:00,Winnings,,10.0,239.81
Draftkings,2022-01-12 20:54:00,Winnings,,1.25,241.06
Draftkings,2022-01-12 20:59:00,Winnings,,9.54,250.6
Draftkings,2022-01-12 21:00:00,Winnings,,1.14,251.74
Draftkings,2022-01-12 21:06:00,Winnings,,1.81,265.8
Draftkings,2022-01-12 21:06:00,Winnings,,12.25,263.99
Draftkings,2022-01-13 12:08:00,Wager,,-25.0,240.8
Draftkings,2022-01-13 23:24:00,Winnings,,37.5,278.3
Draftkings,2022-01-14 00:20:00,Wager,,-25.34,252.96
Draftkings,2022-01-14 21:03:00,Wager,,-2.0,250.96
Draftkings,2022-01-15 11:58:00,Wager,,-10.0,240.96
Draftkings,2022-01-15 19:05:00,Wager,,-12.0,228.96
Draftkings,2022-01-15 20:35:00,Winnings,,48.37,277.33
Draftkings,2022-01-16 12:56:00,Wager,,-2.0,275.33
Draftkings,2022-01-16 16:14:00,Winnings,,12.5,287.83
Draftkings,2022-01-16 16:27:00,Wager,,-10.0,277.83
Draftkings,2022-01-16 16:27:00,Wager,,-2.83,275.0
Draftkings,2022-01-16 20:33:00,Winnings,,5.0,280.0
Draftkings,2022-01-16 20:33:00,Winnings,,0.66,280.66
Draftkings,2022-01-16 23:43:00,Winnings,,10.0,290.66
Draftkings,2022-01-17 14:44:00,Winnings,,23.8,314.46
Draftkings,2022-01-17 16:52:00,Wager,,-10.0,304.46
Draftkings,2022-01-18 19:52:00,Wager,,-8.0,296.46
Draftkings,2022-01-19 17:40:00,Wager,,-5.0,291.46
Draftkings,2022-01-19 18:06:00,Wager,,-5.0,286.46
Draftkings,2022-01-20 13:21:00,Wager,,-33.0,253.46
Draftkings,2022-01-20 16:23:00,Wager,,-10.0,243.46
Draftkings,2022-01-20 22:21:00,Wager,,-3.0,240.46
Draftkings,2022-01-20 22:21:00,Wager,,-3.0,237.46
Draftkings,2022-01-20 22:22:00,Wager,,-3.0,234.46
Draftkings,2022-01-21 01:07:00,Winnings,,22.51,263.54
Draftkings,2022-01-21 01:07:00,Winnings,,0.72,241.03
Draftkings,2022-01-21 01:07:00,Winnings,,5.85,240.31
Draftkings,2022-01-22 14:26:00,Wager,,-1.0,262.54
Draftkings,2022-01-22 14:27:00,Wager,,-3.0,259.54
Draftkings,2022-01-22 19:33:00,Winnings,,20.4,279.94
Draftkings,2022-01-22 23:13:00,Winnings,,19.0,298.94
Draftkings,2022-01-23 10:34:00,Wager,,-7.0,291.94
Draftkings,2022-01-23 15:04:00,Wager,,-10.0,281.94
Draftkings,2022-01-23 15:06:00,Winnings,,26.5,308.44
Draftkings,2022-01-23 17:19:00,Winnings,,15.53,323.97
Draftkings,2022-01-23 18:53:00,Wager,,-8.0,315.97
Draftkings,2022-01-25 19:31:00,Wager,,-6.0,309.97
Draftkings,2022-01-25 19:33:00,Wager,,-4.97,305.0
Draftkings,2022-01-26 01:03:00,Winnings,,15.34,320.34
Draftkings,2022-01-26 17:34:00,Wager,,-8.0,312.34
Draftkings,2022-01-26 22:10:00,Winnings,,24.35,336.69
Draftkings,2022-01-27 13:44:00,Wager,,-14.1,322.59
Draftkings,2022-01-27 19:04:00,Wager,,-6.0,316.59
Draftkings,2022-01-27 23:04:00,Winnings,,3.21,359.43
Draftkings,2022-01-27 23:04:00,Winnings,,12.72,356.22
Draftkings,2022-01-27 23:04:00,Winnings,,26.91,343.5
Draftkings,2022-01-28 01:00:00,Winnings,,16.17,375.6
Draftkings,2022-01-28 18:45:00,Wager,,-2.6,373.0
Draftkings,2022-01-28 18:50:00,Wager,,-8.0,365.0
Draftkings,2022-01-29 11:56:00,Wager,,-5.0,360.0
Draftkings,2022-01-29 12:00:00,Wager,,-8.0,352.0
Draftkings,2022-01-29 18:14:00,Winnings,,21.05,373.05
Draftkings,2022-01-29 21:17:00,Wager,,-1.0,372.05
Draftkings,2022-01-29 21:20:00,Wager,,-1.0,371.05
Draftkings,2022-01-30 10:02:00,Wager,,-10.0,361.05
Draftkings,2022-01-30 10:10:00,Wager,,-15.0,346.05
Draftkings,2022-01-30 14:38:00,Wager,,-10.0,336.05
Draftkings,2022-01-30 15:19:00,Winnings,,8.0,344.05
Draftkings,2022-01-30 17:15:00,Winnings,,15.4,359.45
Draftkings,2022-01-30 17:16:00,Winnings,,4.6,364.05
Draftkings,2022-01-30 18:19:00,Winnings,,20.8,384.85
Draftkings,2022-01-30 18:38:00,Wager,,-17.0,367.85
Draftkings,2022-01-30 18:52:00,Winnings,,36.0,403.85
Draftkings,2022-01-30 20:35:00,Wager,,-10.0,393.85
Draftkings,2022-01-30 20:42:00,Winnings,,21.0,414.85
Draftkings,2022-01-30 22:14:00,Winnings,,50.15,465.0
Draftkings,2022-01-31 12:31:00,Wager,,-10.0,455.0
Draftkings,2022-02-01 00:02:00,Winnings,,31.28,486.28
Draftkings,2022-02-01 16:37:00,Wager,,-6.28,480.0
Draftkings,2022-02-01 16:48:00,Wager,,-5.0,475.0
Draftkings,2022-02-01 21:33:00,Winnings,,13.18,488.18
Draftkings,2022-02-01 21:33:00,Winnings,,1.38,489.56
Draftkings,2022-02-02 18:56:00,Wager,,-5.0,484.56
Draftkings,2022-02-02 18:58:00,Wager,,-1.56,483.0
Draftkings,2022-02-02 20:45:00,Winnings,,20.98,503.98
Draftkings,2022-02-02 21:01:00,Winnings,,0.27,507.6
Draftkings,2022-02-02 21:01:00,Winnings,,3.35,507.33
Draftkings,2022-02-02 22:47:00,Wager,,-1.0,506.6
Draftkings,2022-02-03 20:22:00,Wager,,-4.0,502.6
Draftkings,2022-02-04 00:57:00,Winnings,,17.7,520.3
Draftkings,2022-02-05 09:31:00,Wager,,-5.0,515.3
Draftkings,2022-02-05 09:36:00,Wager,,-6.3,509.0
Draftkings,2022-02-05 18:04:00,Wager,,-20.0,489.0
Draftkings,2022-02-06 20:24:00,Winnings,,14.0,503.0
Draftkings,2022-02-06 20:40:00,Winnings,,6.0,509.0
Draftkings,2022-02-06 23:40:00,Winnings,,41.0,550.0
Draftkings,2022-02-07 19:12:00,Wager,,-5.0,545.0
Draftkings,2022-02-08 18:06:00,Wager,,-5.0,540.0
Draftkings,2022-02-08 18:18:00,Wager,,-5.0,535.0
Draftkings,2022-02-08 21:21:00,Winnings,,12.75,547.75
Draftkings,2022-02-08 21:21:00,Winnings,,1.55,549.3
Draftkings,2022-02-09 00:57:00,Wager,,-6.3,543.0
Draftkings,2022-02-10 19:14:00,Wager,,-5.0,538.0
Draftkings,2022-02-10 19:34:00,Wager,,-5.0,533.0
Draftkings,2022-02-11 15:59:00,Wager,,-5.0,528.0
Draftkings,2022-02-11 18:29:00,Wager,,-20.0,508.0
Draftkings,2022-02-12 17:50:00,Wager,,-20.0,488.0
Draftkings,2022-02-12 18:01:00,Wager,,-5.0,483.0
Draftkings,2022-02-13 11:30:00,Wager,,-4.0,479.0
Draftkings,2022-02-13 16:07:00,Wager,,-10.0,469.0
Draftkings,2022-02-13 16:09:00,Wager,,-1.0,468.0
Draftkings,2022-02-13 18:41:00,Wager,,-10.0,458.0
Draftkings,2022-02-13 18:41:00,Wager,,-10.0,448.0
Draftkings,2022-02-13 18:42:00,Wager,,10.0,458.0
Draftkings,2022-02-13 18:56:00,Winnings,,10.0,468.0
Draftkings,2022-02-13 19:49:00,Winnings,,31.42,499.42
Draftkings,2022-02-13 19:51:00,Winnings,,8.58,508.0
Draftkings,2022-02-14 19:04:00,Wager,,-25.0,483.0
Draftkings,2022-02-14 19:12:00,Wager,,-25.0,458.0
Draftkings,2022-02-14 19:17:00,Wager,,-10.0,448.0
Draftkings,2022-02-14 21:33:00,Wager,,-5.0,443.0
Draftkings,2022-02-14 21:33:00,Wager,,-5.0,438.0
Draftkings,2022-02-14 21:34:00,Wager,,-5.0,433.0
Draftkings,2022-02-14 22:38:00,Winnings,,35.5,468.5
Draftkings,2022-02-15 18:39:00,Wager,,-10.0,458.5
Draftkings,2022-02-15 20:26:00,Wager,,-30.0,428.5
Draftkings,2022-02-15 21:52:00,Winnings,,10.25,438.75
Draftkings,2022-02-15 21:53:00,Winnings,,1.31,440.06
Draftkings,2022-02-15 23:19:00,Winnings,,70.5,510.56
Draftkings,2022-02-15 23:19:00,Winnings,,40.5,551.06
Draftkings,2022-02-16 17:06:00,Wager,,-6.06,545.0
Draftkings,2022-02-16 20:20:00,Wager,,-3.0,542.0
Draftkings,2022-02-16 23:29:00,Winnings,,21.21,563.21
Draftkings,2022-02-16 23:29:00,Winnings,,4.99,568.2
Draftkings,2022-02-17 19:12:00,Wager,,-13.2,555.0
Draftkings,2022-02-17 19:18:00,Wager,,-5.0,550.0
Draftkings,2022-02-18 18:05:00,Wager,,-10.0,540.0
Draftkings,2022-02-18 18:07:00,Wager,,-5.0,535.0
Draftkings,2022-02-18 20:53:00,Wager,,-6.0,529.0
Draftkings,2022-02-18 21:52:00,Winnings,,1.72,541.93
Draftkings,2022-02-18 21:52:00,Winnings,,11.21,540.21
Draftkings,2022-02-19 11:32:00,Wager,,-5.0,536.93
Draftkings,2022-02-20 11:05:00,Wager,,-6.93,530.0
Draftkings,2022-02-20 13:11:00,Wager,,-7.0,523.0
Draftkings,2022-02-20 13:17:00,Wager,,-8.0,515.0
Draftkings,2022-02-20 18:18:00,Winnings,,14.0,529.0
Draftkings,2022-02-20 18:18:00,Winnings,,3.5,532.5
Draftkings,2022-02-20 18:45:00,Winnings,,15.59,548.09
Draftkings,2022-02-20 18:45:00,Winnings,,1.73,549.82
Draftkings,2022-02-20 19:16:00,Winnings,,10.0,559.82
Draftkings,2022-02-21 20:12:00,Wager,,-5.0,554.82
Draftkings,2022-02-22 16:30:00,Wager,,-9.82,545.0
Draftkings,2022-02-22 18:56:00,Wager,,-5.0,540.0
Draftkings,2022-02-22 20:56:00,Winnings,,19.64,559.64
Draftkings,2022-02-22 20:57:00,Winnings,,2.16,561.8
Draftkings,2022-02-22 21:06:00,Winnings,,10.5,572.3
Draftkings,2022-02-22 21:06:00,Winnings,,1.21,573.51
Draftkings,2022-02-24 19:11:00,Wager,,-15.0,558.51
Draftkings,2022-02-24 22:58:00,Winnings,,38.25,596.76
Draftkings,2022-02-24 22:58:00,Winnings,,23.25,620.01
Draftkings,2022-02-25 22:15:00,Winnings,,6.0,626.01
Draftkings,2022-02-26 08:51:00,Wager,,-20.0,606.01
Draftkings,2022-02-26 08:55:00,Wager,,-5.0,601.01
Draftkings,2022-02-28 19:49:00,Wager,,-6.01,595.0
Draftkings,2022-02-28 19:57:00,Wager,,-5.0,590.0
Draftkings,2022-02-28 22:44:00,Winnings,,32.0,622.0
Draftkings,2022-03-01 01:05:00,Winnings,,32.02,654.02
Draftkings,2022-03-01 17:17:00,Wager,,-12.0,642.02
Draftkings,2022-03-01 19:09:00,Wager,,-7.02,635.0
Draftkings,2022-03-02 17:07:00,Wager,,-13.0,622.0
Draftkings,2022-03-02 22:55:00,Winnings,,39.65,661.65
Draftkings,2022-03-02 22:55:00,Winnings,,13.32,674.97
Draftkings,2022-03-03 18:14:00,Wager,,-12.0,662.97
Draftkings,2022-03-03 23:03:00,Winnings,,31.42,694.39
Draftkings,2022-03-03 23:03:00,Winnings,,9.72,704.11
Draftkings,2022-03-04 18:59:00,Wager,,-15.0,689.11
Draftkings,2022-03-04 22:47:00,Winnings,,43.5,732.61
Draftkings,2022-03-04 22:47:00,Winnings,,14.25,746.86
Draftkings,2022-03-05 11:15:00,Wager,,-16.86,730.0
Draftkings,2022-03-05 16:09:00,Winnings,,32.91,762.91
Draftkings,2022-03-05 16:10:00,Winnings,,8.03,770.94
Draftkings,2022-03-05 17:32:00,Wager,,-10.0,760.94
Draftkings,2022-03-05 17:36:00,Wager,,-4.0,756.94
Draftkings,2022-03-05 17:37:00,Wager,,-3.94,753.0
Draftkings,2022-03-06 10:19:00,Wager,,-5.0,748.0
Draftkings,2022-03-06 18:32:00,Winnings,,7.0,755.0
Draftkings,2022-03-07 18:06:00,Wager,,-9.0,746.0
Draftkings,2022-03-08 16:31:00,Wager,,-8.0,738.0
Draftkings,2022-03-08 16:38:00,Wager,,-10.0,728.0
Draftkings,2022-03-09 18:58:00,Wager,,-8.0,720.0
Draftkings,2022-03-09 19:03:00,Wager,,-6.0,714.0
Draftkings,2022-03-09 22:36:00,Winnings,,14.4,728.4
Draftkings,2022-03-09 22:37:00,Winnings,,2.1,730.5
Draftkings,2022-03-10 17:59:00,Wager,,-10.0,720.5
Draftkings,2022-03-10 18:05:00,Wager,,-10.5,710.0
Draftkings,2022-03-10 20:57:00,Wager,,-20.0,690.0
Draftkings,2022-03-10 23:41:00,Wager,,-10.0,680.0
Draftkings,2022-03-11 16:41:00,Wager,,-12.0,668.0
Draftkings,2022-03-11 16:45:00,Wager,,-7.0,661.0
Draftkings,2022-03-11 19:12:00,Wager,,1.0,661.0
Draftkings,2022-03-11 19:12:00,Wager,,-1.0,660.0
Draftkings,2022-03-11 19:44:00,Wager,,-1.0,660.0
Draftkings,2022-03-11 19:47:00,Winnings,,1.95,661.95
Draftkings,2022-03-11 23:08:00,Winnings,,20.3,682.25
Draftkings,2022-03-11 23:08:00,Winnings,,6.65,688.9
Draftkings,2022-03-11 23:26:00,Winnings,,35.4,724.3
Draftkings,2022-03-11 23:26:00,Winnings,,11.7,736.0
Draftkings,2022-03-12 00:02:00,Wager,,-1.0,735.0
Draftkings,2022-03-12 17:24:00,Wager,,-7.0,728.0
Draftkings,2022-03-13 13:03:00,Wager,,-4.0,724.0
Draftkings,2022-03-13 17:41:00,Wager,,-7.0,717.0
Draftkings,2022-03-17 20:12:00,Wager,,-11.0,706.0
Draftkings,2022-03-18 17:52:00,Wager,,-6.0,700.0
Draftkings,2022-03-18 21:47:00,Wager,,-2.0,698.0
Draftkings,2022-03-19 08:24:00,Wager,,-7.0,691.0
Draftkings,2022-03-19 08:26:00,Wager,,-7.0,684.0
Draftkings,2022-03-20 12:53:00,Wager,,-10.0,674.0
Draftkings,2022-03-20 19:46:00,Wager,,-20.0,654.0
Draftkings,2022-03-20 21:21:00,Winnings,,20.0,674.0
Draftkings,2022-03-20 21:22:00,Winnings,,3.2,677.2
Draftkings,2022-03-21 21:01:00,Wager,,-5.0,672.2
Draftkings,2022-03-21 21:01:00,Wager,,-3.0,669.2
Draftkings,2022-03-22 02:11:00,Winnings,,5.72,674.92
Draftkings,2022-03-22 02:11:00,Winnings,,0.68,675.6
Draftkings,2022-03-24 19:31:00,Wager,,-10.0,665.6
Draftkings,2022-03-25 21:40:00,Wager,,-8.0,657.6
Draftkings,2022-03-26 19:50:00,Wager,,-7.0,650.6
Draftkings,2022-03-30 16:43:00,Wager,,-2.6,648.0
Draftkings,2022-04-01 19:23:00,Wager,,-5.0,643.0
Draftkings,2022-04-01 22:50:00,Winnings,,15.5,658.5
Draftkings,2022-04-01 22:50:00,Winnings,,2.62,661.12
Draftkings,2022-04-02 17:44:00,Wager,,-4.0,657.12
Draftkings,2022-04-02 17:49:00,Wager,,-20.0,637.12
Draftkings,2022-04-02 17:52:00,Wager,,-3.12,634.0
Draftkings,2022-04-02 22:34:00,Winnings,,1.96,645.0
Draftkings,2022-04-02 22:34:00,Winnings,,9.04,643.04
Draftkings,2022-04-03 13:56:00,Wager,,-6.0,639.0
Draftkings,2022-04-03 17:10:00,Wager,,-4.0,635.0
Draftkings,2022-04-03 20:47:00,Winnings,,21.0,656.0
Draftkings,2022-04-03 20:47:00,Winnings,,4.95,660.95
Draftkings,2022-04-04 21:19:00,Wager,,-5.95,655.0
Draftkings,2022-04-07 11:09:00,Wager,,-5.0,650.0
Draftkings,2022-04-07 11:11:00,Wager,,-7.0,643.0
Draftkings,2022-04-07 11:11:00,Wager,,-1.0,642.0
Draftkings,2022-04-07 11:13:00,Wager,,-2.0,640.0
Draftkings,2022-04-07 14:48:00,Winnings,,9.16,649.16
Draftkings,2022-04-07 14:48:00,Winnings,,2.84,652.0
Draftkings,2022-04-08 17:09:00,Wager,,-7.0,645.0
Draftkings,2022-04-08 17:10:00,Wager,,-10.0,635.0
Draftkings,2022-04-09 11:36:00,Wager,,-8.0,627.0
Draftkings,2022-04-09 11:41:00,Wager,,-17.0,610.0
Draftkings,2022-04-09 18:02:00,Winnings,,25.2,635.2
Draftkings,2022-04-09 18:02:00,Winnings,,4.3,639.5
Draftkings,2022-04-09 19:32:00,Wager,,-4.5,635.0
Draftkings,2022-04-09 19:35:00,Wager,,-4.0,631.0
Draftkings,2022-04-09 22:48:00,Winnings,,12.6,643.6
Draftkings,2022-04-09 22:48:00,Winnings,,2.02,645.62
Draftkings,2022-04-10 12:43:00,Wager,,-17.0,628.62
Draftkings,2022-04-10 12:55:00,Wager,,-5.0,623.62
Draftkings,2022-04-10 12:58:00,Wager,,-2.62,621.0
Draftkings,2022-04-10 19:02:00,Winnings,,5.77,626.77
Draftkings,2022-04-10 19:07:00,Winnings,,0.32,627.09
Draftkings,2022-04-10 23:18:00,Winnings,,36.55,717.19
Draftkings,2022-04-10 23:18:00,Winnings,,53.55,680.64
Draftkings,2022-04-11 18:27:00,Wager,,-5.0,712.19
Draftkings,2022-04-11 18:31:00,Wager,,-4.19,708.0
Draftkings,2022-04-12 16:36:00,Wager,,-10.0,698.0
Draftkings,2022-04-12 16:45:00,Wager,,-12.0,686.0
Draftkings,2022-04-12 16:47:00,Wager,,-4.0,682.0
Draftkings,2022-04-12 21:47:00,Winnings,,33.0,715.0
Draftkings,2022-04-13 11:34:00,Wager,,-5.0,710.0
Draftkings,2022-04-13 15:36:00,Winnings,,16.75,726.75
Draftkings,2022-04-13 15:36:00,Winnings,,2.93,729.68
Draftkings,2022-04-13 18:05:00,Wager,,-5.68,724.0
Draftkings,2022-04-13 18:09:00,Wager,,-4.0,720.0
Draftkings,2022-04-13 18:11:00,Wager,,-10.0,710.0
Draftkings,2022-04-13 21:07:00,Wager,,-5.0,705.0
Draftkings,2022-04-14 16:23:00,Wager,,-7.0,698.0
Draftkings,2022-04-14 16:28:00,Wager,,-10.0,688.0
Draftkings,2022-04-15 18:43:00,Wager,,-10.0,678.0
Draftkings,2022-04-15 18:46:00,Wager,,-5.0,673.0
Draftkings,2022-04-15 22:27:00,Winnings,,31.0,704.0
Draftkings,2022-04-15 23:23:00,Winnings,,6.75,710.75
Draftkings,2022-04-16 01:24:00,Winnings,,29.0,739.75
Draftkings,2022-04-16 16:15:00,Wager,,-10.0,729.75
Draftkings,2022-04-16 16:19:00,Wager,,-7.0,722.75
Draftkings,2022-04-16 16:20:00,Wager,,-0.75,722.0
Draftkings,2022-04-16 22:21:00,Winnings,,30.1,752.1
Draftkings,2022-04-17 13:48:00,Wager,,-6.0,746.1
Draftkings,2022-04-17 13:50:00,Wager,,-10.0,736.1
Draftkings,2022-04-17 18:27:00,Winnings,,33.5,769.6
Draftkings,2022-04-17 18:45:00,Wager,,-10.0,759.6
Draftkings,2022-04-17 18:49:00,Wager,,-4.0,755.6
Draftkings,2022-04-18 18:05:00,Wager,,-10.0,745.6
Draftkings,2022-04-18 23:14:00,Winnings,,37.5,783.1
Draftkings,2022-04-19 19:13:00,Wager,,-10.0,773.1
Draftkings,2022-04-19 19:16:00,Wager,,-20.0,753.1
Draftkings,2022-04-19 23:31:00,Wager,,-20.0,733.1
Draftkings,2022-04-20 01:00:00,Winnings,,27.84,760.94
Draftkings,2022-04-20 20:29:00,Wager,,-10.0,750.94
Draftkings,2022-04-20 20:35:00,Wager,,-10.0,740.94
Draftkings,2022-04-20 21:46:00,Winnings,,25.5,766.44
Draftkings,2022-04-20 21:46:00,Winnings,,3.87,770.31
Draftkings,2022-04-21 00:25:00,Winnings,,11.9,782.21
Draftkings,2022-04-21 11:10:00,Wager,,-10.0,772.21
Draftkings,2022-04-21 11:14:00,Wager,,-7.21,765.0
Draftkings,2022-04-21 15:21:00,Wager,,-10.0,755.0
Draftkings,2022-04-22 00:23:00,Wager,,-5.0,750.0
Draftkings,2022-04-22 00:48:00,Winnings,,9.16,759.16
Draftkings,2022-04-22 01:07:00,Winnings,,40.0,799.16
Draftkings,2022-04-22 10:00:00,Wager,,-10.0,789.16
Draftkings,2022-04-22 10:03:00,Wager,,-10.0,779.16
Draftkings,2022-04-22 10:07:00,Wager,,-10.0,769.16
Draftkings,2022-04-22 22:03:00,Winnings,,6.0,775.16
Draftkings,2022-04-22 22:15:00,Winnings,,40.0,815.16
Draftkings,2022-04-22 22:15:00,Winnings,,15.0,830.16
Draftkings,2022-04-22 22:38:00,Winnings,,42.0,872.16
Draftkings,2022-04-22 22:38:00,Winnings,,16.0,888.16
Draftkings,2022-04-23 12:26:00,Wager,,-10.0,878.16
Draftkings,2022-04-23 12:28:00,Wager,,-5.16,873.0
Draftkings,2022-04-23 22:01:00,Winnings,,14.5,887.5
Draftkings,2022-04-23 22:08:00,Winnings,,15.99,903.49
Draftkings,2022-04-23 22:08:00,Winnings,,2.71,906.2
Draftkings,2022-04-24 12:36:00,Wager,,-10.0,896.2
Draftkings,2022-04-24 12:40:00,Wager,,-10.0,886.2
Draftkings,2022-04-24 12:51:00,Wager,,-10.0,876.2
Draftkings,2022-04-25 13:00:00,Wager,,-5.0,871.2
Draftkings,2022-04-25 13:01:00,Wager,,-5.0,866.2
Draftkings,2022-04-25 13:06:00,Wager,,-10.0,856.2
Draftkings,2022-04-26 15:29:00,Wager,,-15.0,841.2
Draftkings,2022-04-26 15:30:00,Wager,,-1.2,840.0
Draftkings,2022-04-26 15:37:00,Wager,,-10.0,830.0
Draftkings,2022-04-26 15:38:00,Wager,,-5.0,825.0
Draftkings,2022-04-26 21:49:00,Winnings,,6.26,831.26
Draftkings,2022-04-26 21:49:00,Winnings,,1.27,832.53
Draftkings,2022-04-27 01:00:00,Winnings,,36.5,869.03
Draftkings,2022-04-27 20:44:00,Wager,,-10.0,859.03
Draftkings,2022-04-27 20:50:00,Wager,,-4.0,855.03
Draftkings,2022-04-28 18:02:00,Wager,,-10.0,845.03
Draftkings,2022-04-29 16:57:00,Wager,,-10.0,835.03
Draftkings,2022-04-29 16:59:00,Wager,,-5.0,830.03
Draftkings,2022-04-29 22:05:00,Winnings,,13.0,843.03
Draftkings,2022-04-30 01:04:00,Winnings,,11.5,854.53
Draftkings,2022-04-30 11:20:00,Wager,,-7.53,847.0
Draftkings,2022-05-01 14:38:00,Wager,,-10.0,837.0
Draftkings,2022-05-01 14:50:00,Wager,,-8.0,829.0
Draftkings,2022-05-01 17:00:00,Winnings,,4.76,833.76
Draftkings,2022-05-01 21:50:00,Winnings,,27.2,860.96
Draftkings,2022-05-01 21:50:00,Winnings,,9.6,870.56
Draftkings,2022-05-02 17:22:00,Wager,,-10.0,860.56
Draftkings,2022-05-02 17:25:00,Wager,,-10.0,850.56
Draftkings,2022-05-02 17:28:00,Wager,,-7.0,843.56
Draftkings,2022-05-03 18:34:00,Wager,,-20.0,823.56
Draftkings,2022-05-03 18:35:00,Wager,,-10.0,813.56
Draftkings,2022-05-04 00:30:00,Winnings,,62.0,957.56
Draftkings,2022-05-04 00:30:00,Winnings,,82.0,895.56
Draftkings,2022-05-04 07:23:00,Wager,,-10.0,947.56
Draftkings,2022-05-04 07:28:00,Wager,,-10.0,937.56
Draftkings,2022-05-05 18:30:00,Wager,,-10.0,927.56
Draftkings,2022-05-06 17:15:00,Wager,,-10.0,917.56
Draftkings,2022-05-06 17:21:00,Wager,,-6.0,911.56
Draftkings,2022-05-07 17:29:00,Wager,,-10.0,901.56
Draftkings,2022-05-07 17:31:00,Wager,,-7.0,894.56
Draftkings,2022-05-08 11:44:00,Wager,,-10.0,884.56
Draftkings,2022-05-08 11:45:00,Wager,,-7.0,877.56
Draftkings,2022-05-08 18:30:00,Winnings,,26.5,904.06
Draftkings,2022-05-09 07:57:00,Wager,,-7.0,897.06
Draftkings,2022-05-09 07:58:00,Wager,,-10.0,887.06
Draftkings,2022-05-09 23:38:00,Winnings,,14.98,902.04
Draftkings,2022-05-10 17:13:00,Wager,,-20.0,882.04
Draftkings,2022-05-10 17:42:00,Wager,,-10.0,872.04
Draftkings,2022-05-10 17:45:00,Wager,,-7.0,865.04
Draftkings,2022-05-11 02:21:00,Winnings,,31.0,896.04
Draftkings,2022-05-11 16:04:00,Wager,,-7.0,889.04
Draftkings,2022-05-11 21:01:00,Winnings,,28.7,917.74
Draftkings,2022-05-12 10:32:00,Wager,,-6.0,911.74
Draftkings,2022-05-12 10:34:00,Wager,,-10.0,901.74
Draftkings,2022-05-12 20:48:00,Winnings,,22.0,923.74
Draftkings,2022-05-12 23:38:00,Winnings,,15.3,939.04
Draftkings,2022-05-13 11:09:00,Wager,,-4.04,935.0
Draftkings,2022-05-13 11:10:00,Wager,,-8.0,927.0
Draftkings,2022-05-13 11:11:00,Wager,,-5.0,922.0
Draftkings,2022-05-13 22:03:00,Winnings,,14.5,936.5
Draftkings,2022-05-15 15:06:00,Wager,,-10.0,926.5
Draftkings,2022-05-15 15:08:00,Wager,,-5.0,921.5
Draftkings,2022-05-17 15:01:00,Wager,,-20.0,901.5
Draftkings,2022-05-17 15:08:00,Wager,,-7.5,894.0
Draftkings,2022-05-17 15:10:00,Wager,,-4.0,890.0
Draftkings,2022-05-17 21:34:00,Winnings,,22.4,912.4
Draftkings,2022-05-18 12:58:00,Wager,,-9.0,903.4
Draftkings,2022-05-19 18:38:00,Wager,,-2.4,901.0
Draftkings,2022-05-19 18:42:00,Wager,,-8.0,893.0
Draftkings,2022-05-19 18:43:00,Wager,,-10.0,883.0
Draftkings,2022-05-20 14:53:00,Wager,,-3.0,880.0
Draftkings,2022-05-20 14:56:00,Wager,,-8.0,872.0
Draftkings,2022-05-21 20:25:00,Wager,,-12.0,860.0
Draftkings,2022-05-21 20:31:00,Wager,,-6.0,854.0
Draftkings,2022-05-21 20:35:00,Winnings,,6.0,860.0
Draftkings,2022-05-21 20:56:00,Winnings,,3.57,863.57
Draftkings,2022-05-21 22:19:00,Winnings,,22.43,886.0
Draftkings,2022-05-21 22:20:00,Winnings,,3.55,889.55
Draftkings,2022-05-21 23:09:00,Wager,,-4.55,885.0
Draftkings,2022-05-21 23:09:00,Wager,,4.55,889.55
Draftkings,2022-05-21 23:10:00,Wager,,-4.55,885.0
Draftkings,2022-05-23 18:31:00,Wager,,-10.0,875.0
Draftkings,2022-05-23 18:33:00,Wager,,-7.0,868.0
Draftkings,2022-05-23 23:57:00,Wager,,-5.0,863.0
Draftkings,2022-05-24 18:03:00,Wager,,-20.0,843.0
Draftkings,2022-05-24 18:04:00,Wager,,-10.0,833.0
Draftkings,2022-05-24 18:11:00,Wager,,-3.0,830.0
Draftkings,2022-05-25 18:02:00,Wager,,-10.0,820.0
Draftkings,2022-05-25 18:03:00,Wager,,-7.0,813.0
Draftkings,2022-05-26 17:34:00,Wager,,-8.0,805.0
Draftkings,2022-05-26 17:35:00,Wager,,-5.0,800.0
Draftkings,2022-05-26 23:32:00,Wager,,-7.0,793.0
Draftkings,2022-05-28 19:54:00,Wager,,-2.0,791.0
Draftkings,2022-05-28 19:55:00,Wager,,-3.0,788.0
Draftkings,2022-05-29 14:49:00,Wager,,-10.0,778.0
Draftkings,2022-05-30 20:31:00,Wager,,-5.0,773.0
Draftkings,2022-05-31 00:39:00,Winnings,,18.25,791.25
Draftkings,2022-05-31 00:39:00,Winnings,,3.97,795.22
Draftkings,2022-05-31 16:34:00,Wager,,-20.0,775.22
Draftkings,2022-06-02 18:22:00,Wager,,-15.0,765.7
Draftkings,2022-06-02 18:24:00,Wager,,-10.0,755.7
Draftkings,2022-06-02 18:30:00,Wager,,-4.0,751.7
Draftkings,2022-06-02 18:31:00,Wager,,-5.0,746.7
Draftkings,2022-06-03 11:15:00,Winnings,Bonus,24.38,771.08
Draftkings,2022-06-03 12:58:00,Wager,,-6.0,765.08
Draftkings,2022-06-03 13:10:00,Wager,,-3.0,762.08
Draftkings,2022-06-03 16:46:00,Winnings,,9.0,771.08
Draftkings,2022-06-03 16:46:00,Winnings,,1.5,772.58
Draftkings,2022-06-04 14:27:00,Wager,,-6.0,766.58
Draftkings,2022-06-04 14:28:00,Wager,,-1.0,765.58
Draftkings,2022-06-04 14:28:00,Wager,,1.0,766.58
Draftkings,2022-06-06 16:57:00,Wager,,-5.0,761.58
Draftkings,2022-06-06 16:57:00,Wager,,-10.0,751.58
Draftkings,2022-06-07 16:04:00,Wager,,-20.0,731.58
Draftkings,2022-06-07 16:06:00,Wager,,-10.0,721.58
Draftkings,2022-06-08 18:28:00,Wager,,-0.58,721.0
Draftkings,2022-06-08 23:46:00,Winnings,,2.17,723.17
Draftkings,2022-06-11 13:19:00,Wager,,-10.0,713.17
Draftkings,2022-06-11 13:24:00,Wager,,-20.0,693.17
Draftkings,2022-06-12 09:22:00,Wager,,-10.0,683.17
Draftkings,2022-06-12 16:39:00,Winnings,,10.0,693.17
Draftkings,2022-06-12 22:26:00,Wager,,-3.17,690.0
Draftkings,2022-06-13 14:30:00,Wager,,-5.0,685.0
Draftkings,2022-06-13 20:13:00,Winnings,,25.0,710.0
Draftkings,2022-06-14 08:09:00,Wager,,-10.0,700.0
Draftkings,2022-06-15 22:28:00,Winnings,,25.0,725.0
Draftkings,2022-06-21 17:25:00,Wager,,-10.0,715.0
Draftkings,2022-06-21 22:39:00,Winnings,,27.0,742.0
Draftkings,2022-06-22 10:06:00,Wager,,-10.0,732.0
Draftkings,2022-06-22 10:10:00,Wager,,-2.0,730.0
Draftkings,2022-06-22 23:34:00,Winnings,,33.0,763.0
Draftkings,2022-06-23 13:05:00,Wager,,-10.0,753.0
Draftkings,2022-06-26 11:24:00,Wager,,-3.0,750.0
Draftkings,2022-07-01 08:33:00,Wager,,-5.0,745.0
Draftkings,2022-07-04 19:23:00,Wager,,-10.0,735.0
Draftkings,2022-07-04 19:24:00,Wager,,-10.0,725.0
Draftkings,2022-07-09 10:50:00,Wager,,-10.0,715.0
Draftkings,2022-07-13 18:39:00,Wager,,-5.0,710.0
Draftkings,2022-07-19 22:25:00,Wager,,-2.0,708.0
Draftkings,2022-07-25 19:35:00,Wager,,-5.0,703.0
Draftkings,2022-07-28 19:16:00,Wager,,-8.0,695.0
Draftkings,2022-07-28 23:56:00,Winnings,,5.0,728.0
Draftkings,2022-07-28 23:56:00,Winnings,,28.0,723.0
Draftkings,2022-07-30 13:30:00,Wager,,-20.0,708.0
Draftkings,2022-08-01 10:56:00,Wager,,-6.0,702.0
Draftkings,2022-08-02 19:11:00,Wager,,-5.0,697.0
Draftkings,2022-08-17 22:31:00,Wager,,-3.0,694.0
Draftkings,2022-09-03 10:22:00,Wager,,-10.0,684.0
Draftkings,2022-09-03 10:24:00,Wager,,-7.0,677.0
Draftkings,2022-09-03 21:54:00,Winnings,,28.5,705.5
Draftkings,2022-09-03 21:57:00,Winnings,,9.25,714.75
Draftkings,2022-09-03 23:23:00,Winnings,,25.04,748.81
Draftkings,2022-09-03 23:23:00,Winnings,,9.02,723.77
Draftkings,2022-09-04 00:05:00,Wager,,-20.0,728.81
Draftkings,2022-09-08 18:57:00,Wager,,-10.0,718.81
Draftkings,2022-09-08 19:21:00,Wager,,-1.81,717.0
Draftkings,2022-09-09 18:51:00,Wager,,-5.0,712.0
Draftkings,2022-09-09 18:56:00,Wager,,-12.0,700.0
Draftkings,2022-09-09 18:57:00,Wager,,-3.0,697.0
Draftkings,2022-09-09 22:12:00,Winnings,,5.6,702.6
Draftkings,2022-09-09 22:13:00,Winnings,,0.66,703.26
Draftkings,2022-09-10 16:45:00,Wager,,-10.0,693.26
Draftkings,2022-09-10 16:48:00,Wager,,-5.0,688.26
Draftkings,2022-09-10 16:52:00,Wager,,-5.26,683.0
Draftkings,2022-09-10 16:53:00,Wager,,-3.0,680.0
Draftkings,2022-09-10 21:34:00,Winnings,,20.0,700.0
Draftkings,2022-09-10 21:34:00,Winnings,,3.3,703.3
Draftkings,2022-09-10 22:49:00,Winnings,,14.02,717.32
Draftkings,2022-09-10 22:49:00,Winnings,,2.19,719.51
Draftkings,2022-09-11 11:22:00,Wager,,-5.0,714.51
Draftkings,2022-09-11 15:45:00,Winnings,,5.0,719.51
Draftkings,2022-09-11 18:39:00,Wager,,-1.51,718.0
Draftkings,2022-09-11 18:42:00,Wager,,-8.0,710.0
Draftkings,2022-09-12 18:30:00,Wager,,-10.0,700.0
Draftkings,2022-09-17 16:19:00,Wager,,-15.0,685.0
Draftkings,2022-09-17 16:22:00,Wager,,-10.0,675.0
Draftkings,2022-09-17 17:18:00,Winnings,,10.0,685.0
Draftkings,2022-09-18 11:04:00,Wager,,-3.0,682.0
Draftkings,2022-09-19 18:09:00,Wager,,-7.0,675.0
Draftkings,2022-09-19 18:11:00,Wager,,-2.0,673.0
Draftkings,2022-09-19 23:59:00,Winnings,,5.6,703.41
Draftkings,2022-09-19 23:59:00,Winnings,,24.81,697.81
Draftkings,2022-09-22 11:22:00,Wager,,-10.0,693.41
Draftkings,2022-09-22 11:28:00,Wager,,-10.0,683.41
Draftkings,2022-09-22 11:36:00,Wager,,-6.41,677.0
Draftkings,2022-09-22 19:43:00,Winnings,,15.55,692.55
Draftkings,2022-09-25 09:53:00,Wager,,-10.0,682.55
Draftkings,2022-09-25 09:54:00,Wager,,-1.55,681.0
Draftkings,2022-09-25 09:58:00,Wager,,-2.0,679.0
Draftkings,2022-09-25 15:48:00,Winnings,,9.75,718.25
Draftkings,2022-09-25 15:48:00,Winnings,,29.5,708.5
Draftkings,2022-09-26 15:53:00,Wager,,-7.0,711.25
Draftkings,2022-09-26 16:03:00,Wager,,-7.25,704.0
Draftkings,2022-09-26 21:18:00,Winnings,,9.8,713.8
Draftkings,2022-09-26 21:21:00,Winnings,,4.2,718.0
Draftkings,2022-09-26 21:24:00,Wager,,-3.0,715.0
Draftkings,2022-09-29 18:15:00,Wager,,-5.0,710.0
Draftkings,2022-09-29 18:16:00,Wager,,-10.0,700.0
Draftkings,2022-09-29 18:16:00,Wager,,-10.0,700.0
Draftkings,2022-09-29 18:16:00,Winnings,,10.0,710.0
Draftkings,2022-09-29 18:58:00,Wager,,-10.0,690.0
Draftkings,2022-09-29 22:41:00,Winnings,,45.0,735.0
Draftkings,2022-09-29 22:41:00,Winnings,,10.5,745.5
Draftkings,2022-10-01 11:08:00,Wager,,-4.5,741.0
Draftkings,2022-10-01 22:28:00,Winnings,,12.6,753.6
Draftkings,2022-10-01 22:29:00,Winnings,,2.67,756.27
Draftkings,2022-10-02 11:56:00,Wager,,-1.27,755.0
Draftkings,2022-10-02 11:59:00,Wager,,-4.0,751.0
Draftkings,2022-10-02 19:19:00,Wager,,-3.0,748.0
Draftkings,2022-10-02 20:55:00,Wager,,-2.0,746.0
Draftkings,2022-10-03 16:58:00,Wager,,-5.0,741.0
Draftkings,2022-10-03 17:02:00,Wager,,-6.0,735.0
Draftkings,2022-10-03 17:34:00,Wager,,-3.0,732.0
Draftkings,2022-10-04 14:22:00,Wager,,-10.0,722.0
Draftkings,2022-10-04 14:24:00,Wager,,-5.0,717.0
Draftkings,2022-10-04 18:47:00,Winnings,,17.5,762.0
Draftkings,2022-10-04 18:47:00,Winnings,,27.5,744.5
Draftkings,2022-10-05 19:38:00,Wager,,-10.0,752.0
Draftkings,2022-10-05 19:40:00,Wager,,-2.0,750.0
Draftkings,2022-10-06 13:17:00,Wager,,-10.0,740.0
Draftkings,2022-10-06 13:40:00,Wager,,-10.0,730.0
Draftkings,2022-10-06 13:54:00,Wager,,-1.0,729.0
Draftkings,2022-10-06 19:42:00,Winnings,,14.44,743.44
Draftkings,2022-10-06 19:43:00,Winnings,,5.56,749.0
Draftkings,2022-10-06 21:15:00,Wager,,-1.0,748.0
Draftkings,2022-10-07 11:01:00,Wager,,-5.0,743.0
Draftkings,2022-10-07 17:45:00,Wager,,-3.0,740.0
Draftkings,2022-10-07 17:46:00,Wager,,-7.0,733.0
Draftkings,2022-10-07 17:47:00,Wager,,-1.0,732.0
Draftkings,2022-10-07 21:07:00,Wager,,-3.0,729.0
Draftkings,2022-10-09 11:44:00,Wager,,-2.0,727.0
Draftkings,2022-10-09 11:47:00,Wager,,-8.0,719.0
Draftkings,2022-10-09 11:49:00,Wager,,-1.0,718.0
Draftkings,2022-10-09 11:56:00,Wager,,-4.0,714.0
Draftkings,2022-10-09 12:07:00,Winnings,,5.22,719.22
Draftkings,2022-10-09 12:08:00,Winnings,,1.38,720.6
Draftkings,2022-10-09 15:16:00,Wager,,-1.6,719.0
Draftkings,2022-10-09 15:28:00,Winnings,,13.4,732.4
Draftkings,2022-10-09 15:28:00,Winnings,,3.76,736.16
Draftkings,2022-10-10 18:56:00,Wager,,-6.16,730.0
Draftkings,2022-10-10 20:51:00,Wager,,-5.0,725.0
Draftkings,2022-10-11 12:29:00,Wager,,-2.0,723.0
Draftkings,2022-10-11 12:38:00,Wager,,-10.0,713.0
Draftkings,2022-10-11 12:40:00,Wager,,-5.0,708.0
Draftkings,2022-10-11 21:08:00,Winnings,,15.75,723.75
Draftkings,2022-10-11 21:08:00,Winnings,,3.54,727.29
Draftkings,2022-10-12 10:06:00,Wager,,-3.0,724.29
Draftkings,2022-10-12 19:30:00,Wager,,-3.0,721.29
Draftkings,2022-10-12 19:32:00,Wager,,-6.29,715.0
Draftkings,2022-10-13 17:34:00,Wager,,-25.0,690.0
Draftkings,2022-10-13 17:53:00,Wager,,-6.0,684.0
Draftkings,2022-10-13 18:16:00,Wager,,-20.0,664.0
Draftkings,2022-10-13 21:09:00,Wager,,-10.0,654.0
Draftkings,2022-10-13 22:07:00,Winnings,,45.83,699.83
Draftkings,2022-10-13 22:08:00,Winnings,,18.0,717.83
Draftkings,2022-10-14 14:25:00,Wager,,-10.0,707.83
Draftkings,2022-10-16 11:20:00,Wager,,-5.0,702.83
Draftkings,2022-10-16 11:21:00,Wager,,-5.83,697.0
Draftkings,2022-10-16 11:22:00,Wager,,-7.0,690.0
Draftkings,2022-10-16 15:13:00,Winnings,,20.44,710.44
Draftkings,2022-10-16 15:33:00,Wager,,-10.44,700.0
Draftkings,2022-10-16 16:28:00,Wager,,-1.5,698.5
Draftkings,2022-10-16 22:39:00,Winnings,,9.71,708.21
Draftkings,2022-10-16 22:39:00,Winnings,,1.95,710.16
Draftkings,2022-10-17 12:06:00,Wager,,-10.0,700.16
Draftkings,2022-10-17 12:09:00,Wager,,-10.0,690.16
Draftkings,2022-10-17 12:15:00,Wager,,-3.16,687.0
Draftkings,2022-10-17 20:50:00,Winnings,,10.0,697.0
Draftkings,2022-10-17 20:58:00,Winnings,,3.16,700.16
Draftkings,2022-10-18 21:30:00,Wager,,-10.0,690.16
Draftkings,2022-10-19 19:56:00,Wager,,-3.13,687.03
Draftkings,2022-10-19 19:58:00,Wager,,-6.0,681.03
Draftkings,2022-10-19 20:01:00,Wager,,-10.0,671.03
Draftkings,2022-10-19 20:18:00,Winnings,,11.0,682.03
Draftkings,2022-10-19 20:22:00,Winnings,,9.0,691.03
Draftkings,2022-10-19 21:07:00,Winnings,,9.39,700.42
Draftkings,2022-10-19 21:08:00,Winnings,,2.06,702.48
Draftkings,2022-10-20 17:12:00,Wager,,-10.0,692.48
Draftkings,2022-10-20 17:13:00,Wager,,-0.48,692.0
Draftkings,2022-10-20 17:16:00,Wager,,-7.0,685.0
Draftkings,2022-10-21 12:04:00,Wager,,-10.0,675.0
Draftkings,2022-10-21 12:06:00,Wager,,-10.0,665.0
Draftkings,2022-10-21 12:07:00,Wager,,-3.0,662.0
Draftkings,2022-10-21 18:42:00,Wager,,-4.0,658.0
Draftkings,2022-10-21 19:56:00,Winnings,,16.06,674.06
Draftkings,2022-10-21 19:56:00,Winnings,,3.03,677.09
Draftkings,2022-10-21 22:40:00,Winnings,,12.3,719.89
Draftkings,2022-10-21 22:40:00,Winnings,,30.5,707.59
Draftkings,2022-10-22 14:38:00,Winnings,,8.0,727.89
Draftkings,2022-10-22 14:38:00,Winnings,,1.0,728.89
Draftkings,2022-10-22 16:41:00,Wager,,-8.89,720.0
Draftkings,2022-10-22 16:53:00,Wager,,-7.0,713.0
Draftkings,2022-10-22 16:57:00,Wager,,-10.0,703.0
Draftkings,2022-10-22 17:25:00,Wager,,-10.0,693.0
Draftkings,2022-10-22 22:05:00,Winnings,,16.97,709.97
Draftkings,2022-10-22 22:05:00,Winnings,,2.02,711.99
Draftkings,2022-10-22 23:11:00,Wager,,-6.99,705.0
Draftkings,2022-10-23 00:51:00,Winnings,,13.34,718.34
Draftkings,2022-10-23 00:51:00,Winnings,,3.18,721.52
Draftkings,2022-10-23 12:01:00,Wager,,-21.52,700.0
Draftkings,2022-10-23 12:09:00,Wager,,-6.0,694.0
Draftkings,2022-10-23 16:10:00,Wager,,-4.0,690.0
Draftkings,2022-10-23 18:03:00,Wager,,-4.0,686.0
Draftkings,2022-10-23 18:33:00,Winnings,,55.49,741.49
Draftkings,2022-10-23 18:35:00,Winnings,,16.99,758.48
Draftkings,2022-10-23 21:45:00,Winnings,,11.11,769.59
Draftkings,2022-10-23 21:47:00,Winnings,,2.89,772.48
Draftkings,2022-10-24 18:57:00,Wager,,-20.0,752.48
Draftkings,2022-10-24 19:02:00,Wager,,-12.0,740.48
Draftkings,2022-10-24 19:06:00,Wager,,-6.48,734.0
Draftkings,2022-10-24 19:09:00,Wager,,-3.0,731.0
Draftkings,2022-10-24 22:40:00,Winnings,,4.56,744.26
Draftkings,2022-10-24 22:40:00,Winnings,,8.7,739.7
