Book,Time,Action,Bonus,Change,Balance
Draftkings,2021-11-07 10:00:00,Deposit,,150.0,150.0
Draftkings,2021-11-07 10:03:00,Wager,,-5.0,145.0
Draftkings,2021-11-07 20:19:00,Wager,,-10.0,135.0
Draftkings,2021-11-08 13:27:00,Wager,,-7.0,128.0
Draftkings,2021-11-08 18:50:00,Wager,,-10.0,118.0
Draftkings,2021-11-08 23:48:00,Winnings,,23.45,141.45
Draftkings,2021-11-08 23:48:00,Winnings,,8.22,149.67
Draftkings,2021-11-08 23:49:00,Winnings,Bonus,1.0,150.67
Draftkings,2021-11-09 00:26:00,Winnings,,36.0,186.67
Draftkings,2021-11-09 18:52:00,Wager,,-0.67,186.0
Draftkings,2021-11-09 19:23:00,Wager,,-10.0,176.0
Draftkings,2021-11-10 00:11:00,Winnings,,71.42,247.42
Draftkings,2021-11-10 00:11:00,Winnings,Bonus,1.0,248.42
Draftkings,2021-11-10 00:11:00,Winnings,Bonus,1.0,249.42
Draftkings,2021-11-10 00:11:00,Winnings,Bonus,1.0,250.42
Draftkings,2021-11-10 00:11:00,Winnings,Bonus,1.0,251.42
Draftkings,2021-11-10 00:17:00,Winnings,,2.01,253.43
Draftkings,2021-11-10 00:17:00,Winnings,,0.67,254.1
Draftkings,2021-11-10 17:38:00,Wager,,-10.0,244.1
Draftkings,2021-11-10 22:19:00,Winnings,,16.06,260.16
Draftkings,2021-11-10 22:19:00,Winnings,,3.03,263.19
Draftkings,2021-11-10 22:31:00,Winnings,Bonus,1.0,264.19
Draftkings,2021-11-11 12:25:00,Wager,,-10.0,254.19
Draftkings,2021-11-12 18:30:00,Wager,,-1.19,253.0
Draftkings,2021-11-12 20:03:00,Wager,,-2.0,251.0
Draftkings,2021-11-12 22:38:00,Winnings,Bonus,1.0,252.0
Draftkings,2021-11-13 12:24:00,Wager,,-10.0,242.0
Draftkings,2021-11-13 12:26:00,Wager,,-2.0,240.0
Draftkings,2021-11-13 19:04:00,Winnings,Bonus,1.0,241.0
Draftkings,2021-11-14 10:47:00,Wager,,-2.0,239.0
Draftkings,2021-11-14 12:50:00,Wager,,-5.0,234.0
Draftkings,2021-11-14 13:35:00,Winnings,,7.85,241.85
Draftkings,2021-11-14 13:35:00,Winnings,,2.15,244.0
Draftkings,2021-11-14 16:06:00,Winnings,Bonus,1.0,245.0
Draftkings,2021-11-14 16:06:00,Winnings,Bonus,1.0,248.0
Draftkings,2021-11-14 16:06:00,Winnings,Bonus,1.0,246.0
Draftkings,2021-11-14 16:06:00,Winnings,Bonus,1.0,247.0
Draftkings,2021-11-14 17:03:00,Wager,,-10.0,238.0
Draftkings,2021-11-14 17:15:00,Winnings,Bonus,1.0,239.0
Draftkings,2021-11-14 19:22:00,Winnings,Bonus,1.0,240.0
Draftkings,2021-11-14 19:43:00,Wager,,-5.0,235.0
Draftkings,2021-11-14 19:48:00,Wager,,-1.0,234.0
Draftkings,2021-11-15 15:53:00,Wager,,-14.0,220.0
Draftkings,2021-11-15 23:10:00,Winnings,Bonus,1.0,221.0
Draftkings,2021-11-16 19:58:00,Wager,,-1.0,220.0
Draftkings,2021-11-17 16:23:00,Wager,,-5.0,215.0
Draftkings,2021-11-18 23:43:00,Wager,,-5.0,210.0
Draftkings,2021-11-28 20:17:00,Wager,,-10.0,200.0
Draftkings,2021-11-29 00:13:00,Winnings,Bonus,1.0,201.0
Draftkings,2021-11-29 14:01:00,Wager,,-10.0,191.0
Draftkings,2021-11-29 14:02:00,Wager,,-1.0,190.0
Draftkings,2021-11-30 10:26:00,Wager,,-2.0,188.0
Draftkings,2021-11-30 18:39:00,Wager,,-12.0,176.0
Draftkings,2021-11-30 18:41:00,Wager,,-6.0,170.0
Draftkings,2021-11-30 21:29:00,Winnings,,9.52,179.52
Draftkings,2021-11-30 21:32:00,Winnings,Bonus,1.0,180.52
Draftkings,2021-11-30 23:45:00,Winnings,,13.29,193.81
Draftkings,2021-11-30 23:46:00,Winnings,,3.73,197.54
Draftkings,2021-12-01 00:20:00,Winnings,,17.45,214.99
Draftkings,2021-12-01 00:20:00,Winnings,,2.73,217.72
Draftkings,2021-12-01 00:21:00,Winnings,,11.45,229.17
Draftkings,2021-12-01 00:21:00,Winnings,,1.36,230.53
Draftkings,2021-12-01 00:23:00,Winnings,Bonus,1.0,231.53
Draftkings,2021-12-01 18:29:00,Wager,,-10.0,221.53
Draftkings,2021-12-01 21:19:00,Winnings,,5.5,248.03
Draftkings,2021-12-01 21:19:00,Winnings,,21.0,242.53
Draftkings,2021-12-02 19:58:00,Wager,,-10.0,238.03
Draftkings,2021-12-03 15:44:00,Wager,,-50.0,188.03
Draftkings,2021-12-03 23:39:00,Winnings,Bonus,1.0,189.03
Draftkings,2021-12-03 23:39:00,Winnings,Bonus,1.0,190.03
Draftkings,2021-12-04 12:02:00,Wager,,-13.0,177.03
Draftkings,2021-12-04 12:03:00,Wager,,-2.03,175.0
Draftkings,2021-12-04 12:07:00,Wager,,-10.0,165.0
Draftkings,2021-12-04 19:03:00,Winnings,Bonus,1.0,166.0
Draftkings,2021-12-05 14:43:00,Wager,,-0.5,165.5
Draftkings,2021-12-05 15:58:00,Winnings,Bonus,1.0,166.5
Draftkings,2021-12-05 19:37:00,Winnings,Bonus,1.0,167.5
Draftkings,2021-12-05 21:07:00,Wager,,-1.5,166.0
Draftkings,2021-12-05 23:16:00,Winnings,,21.81,187.81
Draftkings,2021-12-05 23:16:00,Winnings,Bonus,1.0,197.5
Draftkings,2021-12-05 23:16:00,Winnings,,8.69,196.5
Draftkings,2021-12-06 19:01:00,Wager,,-5.0,192.5
Draftkings,2021-12-06 19:18:00,Wager,,-2.0,190.5
Draftkings,2021-12-06 20:40:00,Winnings,,5.0,195.5
Draftkings,2021-12-06 20:40:00,Winnings,,0.99,196.49
Draftkings,2021-12-06 21:22:00,Winnings,Bonus,1.0,197.49
Draftkings,2021-12-07 18:49:00,Wager,,-12.0,185.49
Draftkings,2021-12-07 21:55:00,Winnings,,22.43,207.92
Draftkings,2021-12-07 21:56:00,Winnings,,5.22,213.14
Draftkings,2021-12-08 17:27:00,Wager,,-1.14,212.0
Draftkings,2021-12-08 19:19:00,Wager,,-1.0,211.0
Draftkings,2021-12-09 14:23:00,Wager,,-9.0,202.0
Draftkings,2021-12-09 20:28:00,Winnings,,13.28,215.28
Draftkings,2021-12-09 20:29:00,Winnings,,3.91,219.19
Draftkings,2021-12-09 22:40:00,Winnings,Bonus,1.0,220.19
Draftkings,2021-12-12 12:52:00,Wager,,-1.0,219.19
Draftkings,2021-12-12 12:56:00,Wager,,-7.0,212.19
Draftkings,2021-12-14 14:47:00,Wager,,-12.19,200.0
Draftkings,2021-12-15 00:44:00,Winnings,,5.54,228.81
Draftkings,2021-12-15 00:44:00,Winnings,,23.27,223.27
Draftkings,2021-12-15 00:46:00,Winnings,Bonus,1.0,229.81
Draftkings,2021-12-16 10:56:00,Wager,,-17.0,212.81
Draftkings,2021-12-20 23:21:00,Winnings,Bonus,1.0,213.81
Draftkings,2022-01-09 10:04:00,Wager,,-7.0,206.81
Draftkings,2022-01-09 18:58:00,Winnings,Bonus,1.0,207.81
Draftkings,2022-01-09 23:58:00,Wager,,-10.0,197.81
Draftkings,2022-01-10 00:05:00,Winnings,,23.5,221.31
Draftkings,2022-01-10 17:46:00,Wager,,-10.0,211.31
Draftkings,2022-01-10 23:58:00,Winnings,,28.0,239.31
Draftkings,2022-01-11 00:00:00,Winnings,,4.5,243.81
Draftkings,2022-01-11 00:01:00,Winnings,Bonus,1.0,244.81
Draftkings,2022-01-12 17:14:00,Wager,,-5.0,239.81
Draftkings,2022-01-12 17:14:00,Wager,,-5.0,234.81
Draftkings,2022-01-12 17:17:00,Wager,,-5.0,229.81
Draftkings,2022-01-12 20:54:00,Winnings,,10.0,239.81
Draftkings,2022-01-12 20:54:00,Winnings,,1.25,241.06
Draftkings,2022-01-12 20:59:00,Winnings,,9.54,250.6
Draftkings,2022-01-12 21:00:00,Winnings,,1.14,251.74
Draftkings,2022-01-12 21:06:00,Winnings,,1.81,265.8
Draftkings,2022-01-12 21:06:00,Winnings,,12.25,263.99
Draftkings,2022-01-13 12:08:00,Wager,,-25.0,240.8
Draftkings,2022-01-13 23:24:00,Winnings,,37.5,278.3
Draftkings,2022-01-14 00:20:00,Wager,,-25.34,252.96
Draftkings,2022-01-14 21:03:00,Wager,,-2.0,250.96
Draftkings,2022-01-15 11:58:00,Wager,,-10.0,240.96
Draftkings,2022-01-15 19:05:00,Wager,,-12.0,228.96
Draftkings,2022-01-15 20:35:00,Winnings,,48.37,277.33
Draftkings,2022-01-16 12:56:00,Wager,,-2.0,275.33
Draftkings,2022-01-16 16:14:00,Winnings,,12.5,287.83
Draftkings,2022-01-16 16:27:00,Wager,,-2.83,275.0
Draftkings,2022-01-16 16:27:00,Wager,,-10.0,277.83
Draftkings,2022-01-16 20:33:00,Winnings,,5.0,280.0
Draftkings,2022-01-16 20:33:00,Winnings,,0.66,280.66
Draftkings,2022-01-16 23:43:00,Winnings,,10.0,290.66
Draftkings,2022-01-17 14:44:00,Winnings,,23.8,314.46
Draftkings,2022-01-17 16:52:00,Wager,,-10.0,304.46
Draftkings,2022-01-18 19:52:00,Wager,,-8.0,296.46
Draftkings,2022-01-19 17:40:00,Wager,,-5.0,291.46
Draftkings,2022-01-19 18:06:00,Wager,,-5.0,286.46
Draftkings,2022-01-20 13:21:00,Wager,,-33.0,253.46
Draftkings,2022-01-20 16:23:00,Wager,,-10.0,243.46
Draftkings,2022-01-20 22:21:00,Wager,,-3.0,240.46
Draftkings,2022-01-20 22:21:00,Wager,,-3.0,237.46
Draftkings,2022-01-20 22:22:00,Wager,,-3.0,234.46
Draftkings,2022-01-21 01:07:00,Winnings,,22.51,263.54
Draftkings,2022-01-21 01:07:00,Winnings,,5.85,240.31
Draftkings,2022-01-21 01:07:00,Winnings,,0.72,241.03
Draftkings,2022-01-22 14:26:00,Wager,,-1.0,262.54
Draftkings,2022-01-22 14:27:00,Wager,,-3.0,259.54
Draftkings,2022-01-22 19:33:00,Winnings,,20.4,279.94
Draftkings,2022-01-22 23:13:00,Winnings,,19.0,298.94
Draftkings,2022-01-23 10:34:00,Wager,,-7.0,291.94
Draftkings,2022-01-23 15:04:00,Wager,,-10.0,281.94
Draftkings,2022-01-23 15:06:00,Winnings,,26.5,308.44
Draftkings,2022-01-23 17:19:00,Winnings,,15.53,323.97
Draftkings,2022-01-23 18:53:00,Wager,,-8.0,315.97
Draftkings,2022-01-25 19:31:00,Wager,,-6.0,309.97
Draftkings,2022-01-25 19:33:00,Wager,,-4.97,305.0
Draftkings,2022-01-26 01:03:00,Winnings,,15.34,320.34
Draftkings,2022-01-26 17:34:00,Wager,,-8.0,312.34
Draftkings,2022-01-26 22:10:00,Winnings,,24.35,336.69
Draftkings,2022-01-27 13:44:00,Wager,,-14.1,322.59
Draftkings,2022-01-27 19:04:00,Wager,,-6.0,316.59
Draftkings,2022-01-27 23:04:00,Winnings,,26.91,343.5
Draftkings,2022-01-27 23:04:00,Winnings,,12.72,356.22
Draftkings,2022-01-27 23:04:00,Winnings,,3.21,359.43
Draftkings,2022-01-28 01:00:00,Winnings,,16.17,375.6
Draftkings,2022-01-28 18:45:00,Wager,,-2.6,373.0
Draftkings,2022-01-28 18:50:00,Wager,,-8.0,365.0
Draftkings,2022-01-29 11:56:00,Wager,,-5.0,360.0
Draftkings,2022-01-29 12:00:00,Wager,,-8.0,352.0
Draftkings,2022-01-29 18:14:00,Winnings,,21.05,373.05
Draftkings,2022-01-29 21:17:00,Wager,,-1.0,372.05
Draftkings,2022-01-29 21:20:00,Wager,,-1.0,371.05
Draftkings,2022-01-30 10:02:00,Wager,,-10.0,361.05
Draftkings,2022-01-30 10:10:00,Wager,,-15.0,346.05
Draftkings,2022-01-30 14:38:00,Wager,,-10.0,336.05
Draftkings,2022-01-30 15:19:00,Winnings,,8.0,344.05
Draftkings,2022-01-30 17:15:00,Winnings,,15.4,359.45
Draftkings,2022-01-30 17:16:00,Winnings,,4.6,364.05
Draftkings,2022-01-30 18:19:00,Winnings,,20.8,384.85
Draftkings,2022-01-30 18:38:00,Wager,,-17.0,367.85
Draftkings,2022-01-30 18:52:00,Winnings,,36.0,403.85
Draftkings,2022-01-30 20:35:00,Wager,,-10.0,393.85
Draftkings,2022-01-30 20:42:00,Winnings,,21.0,414.85
Draftkings,2022-01-30 22:14:00,Winnings,,50.15,465.0
Draftkings,2022-01-31 12:31:00,Wager,,-10.0,455.0
Draftkings,2022-02-01 00:02:00,Winnings,,31.28,486.28
Draftkings,2022-02-01 16:37:00,Wager,,-6.28,480.0
Draftkings,2022-02-01 16:48:00,Wager,,-5.0,475.0
Draftkings,2022-02-01 21:33:00,Winnings,,1.38,489.56
Draftkings,2022-02-01 21:33:00,Winnings,,13.18,488.18
Draftkings,2022-02-02 18:56:00,Wager,,-5.0,484.56
Draftkings,2022-02-02 18:58:00,Wager,,-1.56,483.0
Draftkings,2022-02-02 20:45:00,Winnings,,20.98,503.98
Draftkings,2022-02-02 21:01:00,Winnings,,3.35,507.33
Draftkings,2022-02-02 21:01:00,Winnings,,0.27,507.6
Draftkings,2022-02-02 22:47:00,Wager,,-1.0,506.6
Draftkings,2022-02-03 20:22:00,Wager,,-4.0,502.6
Draftkings,2022-02-04 00:57:00,Winnings,,17.7,520.3
Draftkings,2022-02-05 09:31:00,Wager,,-5.0,515.3
Draftkings,2022-02-05 09:36:00,Wager,,-6.3,509.0
Draftkings,2022-02-05 18:04:00,Wager,,-20.0,489.0
Draftkings,2022-02-06 20:24:00,Winnings,,14.0,503.0
Draftkings,2022-02-06 20:40:00,Winnings,,6.0,509.0
Draftkings,2022-02-06 23:40:00,Winnings,,41.0,550.0
Draftkings,2022-02-07 19:12:00,Wager,,-5.0,545.0
Draftkings,2022-02-08 18:06:00,Wager,,-5.0,540.0
Draftkings,2022-02-08 18:18:00,Wager,,-5.0,535.0
Draftkings,2022-02-08 21:21:00,Winnings,,1.55,549.3
Draftkings,2022-02-08 21:21:00,Winnings,,12.75,547.75
Draftkings,2022-02-09 00:57:00,Wager,,-6.3,543.0
Draftkings,2022-02-10 19:14:00,Wager,,-5.0,538.0
Draftkings,2022-02-10 19:34:00,Wager,,-5.0,533.0
Draftkings,2022-02-11 15:59:00,Wager,,-5.0,528.0
Draftkings,2022-02-11 18:29:00,Wager,,-20.0,508.0
Draftkings,2022-02-12 17:50:00,Wager,,-20.0,488.0
Draftkings,2022-02-12 18:01:00,Wager,,-5.0,483.0
Draftkings,2022-02-13 11:30:00,Wager,,-4.0,479.0
Draftkings,2022-02-13 16:07:00,Wager,,-10.0,469.0
Draftkings,2022-02-13 16:09:00,Wager,,-1.0,468.0
Draftkings,2022-02-13 18:41:00,Wager,,-10.0,458.0
Draftkings,2022-02-13 18:41:00,Wager,,-10.0,448.0
Draftkings,2022-02-13 18:42:00,Wager,,10.0,458.0
Draftkings,2022-02-13 18:56:00,Winnings,,10.0,468.0
Draftkings,2022-02-13 19:49:00,Winnings,,31.42,499.42
Draftkings,2022-02-13 19:51:00,Winnings,,8.58,508.0
Draftkings,2022-02-14 19:04:00,Wager,,-25.0,483.0
Draftkings,2022-02-14 19:12:00,Wager,,-25.0,458.0
Draftkings,2022-02-14 19:17:00,Wager,,-10.0,448.0
Draftkings,2022-02-14 21:33:00,Wager,,-5.0,438.0
Draftkings,2022-02-14 21:33:00,Wager,,-5.0,443.0
Draftkings,2022-02-14 21:34:00,Wager,,-5.0,433.0
Draftkings,2022-02-14 22:38:00,Winnings,,35.5,468.5
Draftkings,2022-02-15 18:39:00,Wager,,-10.0,458.5
Draftkings,2022-02-15 20:26:00,Wager,,-30.0,428.5
Draftkings,2022-02-15 21:52:00,Winnings,,10.25,438.75
Draftkings,2022-02-15 21:53:00,Winnings,,1.31,440.06
Draftkings,2022-02-15 23:19:00,Winnings,,70.5,510.56
Draftkings,2022-02-15 23:19:00,Winnings,,40.5,551.06
Draftkings,2022-02-16 17:06:00,Wager,,-6.06,545.0
Draftkings,2022-02-16 20:20:00,Wager,,-3.0,542.0
Draftkings,2022-02-16 23:29:00,Winnings,,21.21,563.21
Draftkings,2022-02-16 23:29:00,Winnings,,4.99,568.2
Draftkings,2022-02-17 19:12:00,Wager,,-13.2,555.0
Draftkings,2022-02-17 19:18:00,Wager,,-5.0,550.0
Draftkings,2022-02-18 18:05:00,Wager,,-10.0,540.0
Draftkings,2022-02-18 18:07:00,Wager,,-5.0,535.0
Draftkings,2022-02-18 20:53:00,Wager,,-6.0,529.0
Draftkings,2022-02-18 21:52:00,Winnings,,1.72,541.93
Draftkings,2022-02-18 21:52:00,Winnings,,11.21,540.21
Draftkings,2022-02-19 11:32:00,Wager,,-5.0,536.93
Draftkings,2022-02-20 11:05:00,Wager,,-6.93,530.0
Draftkings,2022-02-20 13:11:00,Wager,,-7.0,523.0
Draftkings,2022-02-20 13:17:00,Wager,,-8.0,515.0
Draftkings,2022-02-20 18:18:00,Winnings,,14.0,529.0
Draftkings,2022-02-20 18:18:00,Winnings,,3.5,532.5
Draftkings,2022-02-20 18:45:00,Winnings,,1.73,549.82
Draftkings,2022-02-20 18:45:00,Winnings,,15.59,548.09
Draftkings,2022-02-20 19:16:00,Winnings,,10.0,559.82
Draftkings,2022-02-21 20:12:00,Wager,,-5.0,554.82
Draftkings,2022-02-22 16:30:00,Wager,,-9.82,545.0
Draftkings,2022-02-22 18:56:00,Wager,,-5.0,540.0
Draftkings,2022-02-22 20:56:00,Winnings,,19.64,559.64
Draftkings,2022-02-22 20:57:00,Winnings,,2.16,561.8
Draftkings,2022-02-22 21:06:00,Winnings,,10.5,572.3
Draftkings,2022-02-22 21:06:00,Winnings,,1.21,573.51
Draftkings,2022-02-24 19:11:00,Wager,,-15.0,558.51
Draftkings,2022-02-24 22:58:00,Winnings,,38.25,596.76
Draftkings,2022-02-24 22:58:00,Winnings,,23.25,620.01
Draftkings,2022-02-25 22:15:00,Winnings,,6.0,626.01
Draftkings,2022-02-26 08:51:00,Wager,,-20.0,606.01
Draftkings,2022-02-26 08:55:00,Wager,,-5.0,601.01
Draftkings,2022-02-28 19:49:00,Wager,,-6.01,595.0
Draftkings,2022-02-28 19:57:00,Wager,,-5.0,590.0
Draftkings,2022-02-28 22:44:00,Winnings,,32.0,622.0
Draftkings,2022-03-01 01:05:00,Winnings,,32.02,654.02
Draftkings,2022-03-01 17:17:00,Wager,,-12.0,642.02
Draftkings,2022-03-01 19:09:00,Wager,,-7.02,635.0
Draftkings,2022-03-02 17:07:00,Wager,,-13.0,622.0
Draftkings,2022-03-02 22:55:00,Winnings,,13.32,674.97
Draftkings,2022-03-02 22:55:00,Winnings,,39.65,661.65
Draftkings,2022-03-03 18:14:00,Wager,,-12.0,662.97
Draftkings,2022-03-03 23:03:00,Winnings,,31.42,694.39
Draftkings,2022-03-03 23:03:00,Winnings,,9.72,704.11
Draftkings,2022-03-04 18:59:00,Wager,,-15.0,689.11
Draftkings,2022-03-04 22:47:00,Winnings,,14.25,746.86
Draftkings,2022-03-04 22:47:00,Winnings,,43.5,732.61
Draftkings,2022-03-05 11:15:00,Wager,,-16.86,730.0
Draftkings,2022-03-05 16:09:00,Winnings,,32.91,762.91
Draftkings,2022-03-05 16:10:00,Winnings,,8.03,770.94
Draftkings,2022-03-05 17:32:00,Wager,,-10.0,760.94
Draftkings,2022-03-05 17:36:00,Wager,,-4.0,756.94
Draftkings,2022-03-05 17:37:00,Wager,,-3.94,753.0
Draftkings,2022-03-06 10:19:00,Wager,,-5.0,748.0
Draftkings,2022-03-06 18:32:00,Winnings,,7.0,755.0
Draftkings,2022-03-07 18:06:00,Wager,,-9.0,746.0
Draftkings,2022-03-08 16:31:00,Wager,,-8.0,738.0
Draftkings,2022-03-08 16:38:00,Wager,,-10.0,728.0
Draftkings,2022-03-09 18:58:00,Wager,,-8.0,720.0
Draftkings,2022-03-09 19:03:00,Wager,,-6.0,714.0
Draftkings,2022-03-09 22:36:00,Winnings,,14.4,728.4
Draftkings,2022-03-09 22:37:00,Winnings,,2.1,730.5
Draftkings,2022-03-10 17:59:00,Wager,,-10.0,720.5
Draftkings,2022-03-10 18:05:00,Wager,,-10.5,710.0
Draftkings,2022-03-10 20:57:00,Wager,,-20.0,690.0
Draftkings,2022-03-10 23:41:00,Wager,,-10.0,680.0
Draftkings,2022-03-11 16:41:00,Wager,,-12.0,668.0
Draftkings,2022-03-11 16:45:00,Wager,,-7.0,661.0
Draftkings,2022-03-11 19:12:00,Wager,,1.0,661.0
Draftkings,2022-03-11 19:12:00,Wager,,-1.0,660.0
Draftkings,2022-03-11 19:44:00,Wager,,-1.0,660.0
Draftkings,2022-03-11 19:47:00,Winnings,,1.95,661.95
Draftkings,2022-03-11 23:08:00,Winnings,,20.3,682.25
Draftkings,2022-03-11 23:08:00,Winnings,,6.65,688.9
Draftkings,2022-03-11 23:26:00,Winnings,,35.4,724.3
Draftkings,2022-03-11 23:26:00,Winnings,,11.7,736.0
Draftkings,2022-03-12 00:02:00,Wager,,-1.0,735.0
Draftkings,2022-03-12 17:24:00,Wager,,-7.0,728.0
Draftkings,2022-03-13 13:03:00,Wager,,-4.0,724.0
Draftkings,2022-03-13 17:41:00,Wager,,-7.0,717.0
Draftkings,2022-03-17 20:12:00,Wager,,-11.0,706.0
Draftkings,2022-03-18 17:52:00,Wager,,-6.0,700.0
Draftkings,2022-03-18 21:47:00,Wager,,-2.0,698.0
Draftkings,2022-03-19 08:24:00,Wager,,-7.0,691.0
Draftkings,2022-03-19 08:26:00,Wager,,-7.0,684.0
Draftkings,2022-03-20 12:53:00,Wager,,-10.0,674.0
Draftkings,2022-03-20 19:46:00,Wager,,-20.0,654.0
Draftkings,2022-03-20 21:21:00,Winnings,,20.0,674.0
Draftkings,2022-03-20 21:22:00,Winnings,,3.2,677.2
Draftkings,2022-03-21 21:01:00,Wager,,-5.0,672.2
Draftkings,2022-03-21 21:01:00,Wager,,-3.0,669.2
Draftkings,2022-03-22 02:11:00,Winnings,,5.72,674.92
Draftkings,2022-03-22 02:11:00,Winnings,,0.68,675.6
Draftkings,2022-03-24 19:31:00,Wager,,-10.0,665.6
Draftkings,2022-03-25 21:40:00,Wager,,-8.0,657.6
Draftkings,2022-03-26 19:50:00,Wager,,-7.0,650.6
Draftkings,2022-03-30 16:43:00,Wager,,-2.6,648.0
Draftkings,2022-04-01 19:23:00,Wager,,-5.0,643.0
Draftkings,2022-04-01 22:50:00,Winnings,,15.5,658.5
Draftkings,2022-04-01 22:50:00,Winnings,,2.62,661.12
Draftkings,2022-04-02 17:44:00,Wager,,-4.0,657.12
Draftkings,2022-04-02 17:49:00,Wager,,-20.0,637.12
Draftkings,2022-04-02 17:52:00,Wager,,-3.12,634.0
Draftkings,2022-04-02 22:34:00,Winnings,,9.04,643.04
Draftkings,2022-04-02 22:34:00,Winnings,,1.96,645.0
Draftkings,2022-04-03 13:56:00,Wager,,-6.0,639.0
Draftkings,2022-04-03 17:10:00,Wager,,-4.0,635.0
Draftkings,2022-04-03 20:47:00,Winnings,,21.0,656.0
Draftkings,2022-04-03 20:47:00,Winnings,,4.95,660.95
Draftkings,2022-04-04 21:19:00,Wager,,-5.95,655.0
Draftkings,2022-04-07 11:09:00,Wager,,-5.0,650.0
Draftkings,2022-04-07 11:11:00,Wager,,-7.0,643.0
Draftkings,2022-04-07 11:11:00,Wager,,-1.0,642.0
Draftkings,2022-04-07 11:13:00,Wager,,-2.0,640.0
Draftkings,2022-04-07 14:48:00,Winnings,,2.84,652.0
Draftkings,2022-04-07 14:48:00,Winnings,,9.16,649.16
Draftkings,2022-04-08 17:09:00,Wager,,-7.0,645.0
Draftkings,2022-04-08 17:10:00,Wager,,-10.0,635.0
Draftkings,2022-04-09 11:36:00,Wager,,-8.0,627.0
Draftkings,2022-04-09 11:41:00,Wager,,-17.0,610.0
Draftkings,2022-04-09 18:02:00,Winnings,,25.2,635.2
Draftkings,2022-04-09 18:02:00,Winnings,,4.3,639.5
Draftkings,2022-04-09 19:32:00,Wager,,-4.5,635.0
Draftkings,2022-04-09 19:35:00,Wager,,-4.0,631.0
Draftkings,2022-04-09 22:48:00,Winnings,,12.6,643.6
Draftkings,2022-04-09 22:48:00,Winnings,,2.02,645.62
Draftkings,2022-04-10 12:43:00,Wager,,-17.0,628.62
Draftkings,2022-04-10 12:55:00,Wager,,-5.0,623.62
Draftkings,2022-04-10 12:58:00,Wager,,-2.62,621.0
Draftkings,2022-04-10 19:02:00,Winnings,,5.77,626.77
Draftkings,2022-04-10 19:07:00,Winnings,,0.32,627.09
Draftkings,2022-04-10 23:18:00,Winnings,,53.55,680.64
Draftkings,2022-04-10 23:18:00,Winnings,,36.55,717.19
Draftkings,2022-04-11 18:27:00,Wager,,-5.0,712.19
Draftkings,2022-04-11 18:31:00,Wager,,-4.19,708.0
Draftkings,2022-04-12 16:36:00,Wager,,-10.0,698.0
Draftkings,2022-04-12 16:45:00,Wager,,-12.0,686.0
Draftkings,2022-04-12 16:47:00,Wager,,-4.0,682.0
Draftkings,2022-04-12 21:47:00,Winnings,,33.0,715.0
Draftkings,2022-04-13 11:34:00,Wager,,-5.0,710.0
Draftkings,2022-04-13 15:36:00,Winnings,,16.75,726.75
Draftkings,2022-04-13 15:36:00,Winnings,,2.93,729.68
Draftkings,2022-04-13 18:05:00,Wager,,-5.68,724.0
Draftkings,2022-04-13 18:09:00,Wager,,-4.0,720.0
Draftkings,2022-04-13 18:11:00,Wager,,-10.0,710.0
Draftkings,2022-04-13 21:07:00,Wager,,-5.0,705.0
Draftkings,2022-04-14 16:23:00,Wager,,-7.0,698.0
Draftkings,2022-04-14 16:28:00,Wager,,-10.0,688.0
Draftkings,2022-04-15 18:43:00,Wager,,-10.0,678.0
Draftkings,2022-04-15 18:46:00,Wager,,-5.0,673.0
Draftkings,2022-04-15 22:27:00,Winnings,,31.0,704.0
Draftkings,2022-04-15 23:23:00,Winnings,,6.75,710.75
Draftkings,2022-04-16 01:24:00,Winnings,,29.0,739.75
Draftkings,2022-04-16 16:15:00,Wager,,-10.0,729.75
Draftkings,2022-04-16 16:19:00,Wager,,-7.0,722.75
Draftkings,2022-04-16 16:20:00,Wager,,-0.75,722.0
Draftkings,2022-04-16 22:21:00,Winnings,,30.1,752.1
Draftkings,2022-04-17 13:48:00,Wager,,-6.0,746.1
Draftkings,2022-04-17 13:50:00,Wager,,-10.0,736.1
Draftkings,2022-04-17 18:27:00,Winnings,,33.5,769.6
Draftkings,2022-04-17 18:45:00,Wager,,-10.0,759.6
Draftkings,2022-04-17 18:49:00,Wager,,-4.0,755.6
Draftkings,2022-04-18 18:05:00,Wager,,-10.0,745.6
Draftkings,2022-04-18 23:14:00,Winnings,,37.5,783.1
Draftkings,2022-04-19 19:13:00,Wager,,-10.0,773.1
Draftkings,2022-04-19 19:16:00,Wager,,-20.0,753.1
Draftkings,2022-04-19 23:31:00,Wager,,-20.0,733.1
Draftkings,2022-04-20 01:00:00,Winnings,,27.84,760.94
Draftkings,2022-04-20 20:29:00,Wager,,-10.0,750.94
Draftkings,2022-04-20 20:35:00,Wager,,-10.0,740.94
Draftkings,2022-04-20 21:46:00,Winnings,,25.5,766.44
Draftkings,2022-04-20 21:46:00,Winnings,,3.87,770.31
Draftkings,2022-04-21 00:25:00,Winnings,,11.9,782.21
Draftkings,2022-04-21 11:10:00,Wager,,-10.0,772.21
Draftkings,2022-04-21 11:14:00,Wager,,-7.21,765.0
Draftkings,2022-04-21 15:21:00,Wager,,-10.0,755.0
Draftkings,2022-04-22 00:23:00,Wager,,-5.0,750.0
Draftkings,2022-04-22 00:48:00,Winnings,,9.16,759.16
Draftkings,2022-04-22 01:07:00,Winnings,,40.0,799.16
Draftkings,2022-04-22 10:00:00,Wager,,-10.0,789.16
Draftkings,2022-04-22 10:03:00,Wager,,-10.0,779.16
Draftkings,2022-04-22 10:07:00,Wager,,-10.0,769.16
Draftkings,2022-04-22 22:03:00,Winnings,,6.0,775.16
Draftkings,2022-04-22 22:15:00,Winnings,,40.0,815.16
Draftkings,2022-04-22 22:15:00,Winnings,,15.0,830.16
Draftkings,2022-04-22 22:38:00,Winnings,,42.0,872.16
Draftkings,2022-04-22 22:38:00,Winnings,,16.0,888.16
Draftkings,2022-04-23 12:26:00,Wager,,-10.0,878.16
Draftkings,2022-04-23 12:28:00,Wager,,-5.16,873.0
Draftkings,2022-04-23 22:01:00,Winnings,,14.5,887.5
Draftkings,2022-04-23 22:08:00,Winnings,,15.99,903.49
Draftkings,2022-04-23 22:08:00,Winnings,,2.71,906.2
Draftkings,2022-04-24 12:36:00,Wager,,-10.0,896.2
Draftkings,2022-04-24 12:40:00,Wager,,-10.0,886.2
Draftkings,2022-04-24 12:51:00,Wager,,-10.0,876.2
Draftkings,2022-04-25 13:00:00,Wager,,-5.0,871.2
Draftkings,2022-04-25 13:01:00,Wager,,-5.0,866.2
Draftkings,2022-04-25 13:06:00,Wager,,-10.0,856.2
Draftkings,2022-04-26 15:29:00,Wager,,-15.0,841.2
Draftkings,2022-04-26 15:30:00,Wager,,-1.2,840.0
Draftkings,2022-04-26 15:37:00,Wager,,-10.0,830.0
Draftkings,2022-04-26 15:38:00,Wager,,-5.0,825.0
Draftkings,2022-04-26 21:49:00,Winnings,,6.26,831.26
Draftkings,2022-04-26 21:49:00,Winnings,,1.27,832.53
Draftkings,2022-04-27 01:00:00,Winnings,,36.5,869.03
Draftkings,2022-04-27 20:44:00,Wager,,-10.0,859.03
Draftkings,2022-04-27 20:50:00,Wager,,-4.0,855.03
Draftkings,2022-04-28 18:02:00,Wager,,-10.0,845.03
Draftkings,2022-04-29 16:57:00,Wager,,-10.0,835.03
Draftkings,2022-04-29 16:59:00,Wager,,-5.0,830.03
Draftkings,2022-04-29 22:05:00,Winnings,,13.0,843.03
Draftkings,2022-04-30 01:04:00,Winnings,,11.5,854.53
Draftkings,2022-04-30 11:20:00,Wager,,-7.53,847.0
Draftkings,2022-05-01 14:38:00,Wager,,-10.0,837.0
Draftkings,2022-05-01 14:50:00,Wager,,-8.0,829.0
Draftkings,2022-05-01 17:00:00,Winnings,,4.76,833.76
Draftkings,2022-05-01 21:50:00,Winnings,,27.2,860.96
Draftkings,2022-05-01 21:50:00,Winnings,,9.6,870.56
Draftkings,2022-05-02 17:22:00,Wager,,-10.0,860.56
Draftkings,2022-05-02 17:25:00,Wager,,-10.0,850.56
Draftkings,2022-05-02 17:28:00,Wager,,-7.0,843.56
Draftkings,2022-05-03 18:34:00,Wager,,-20.0,823.56
Draftkings,2022-05-03 18:35:00,Wager,,-10.0,813.56
Draftkings,2022-05-04 00:30:00,Winnings,,62.0,957.56
Draftkings,2022-05-04 00:30:00,Winnings,,82.0,895.56
Draftkings,2022-05-04 07:23:00,Wager,,-10.0,947.56
Draftkings,2022-05-04 07:28:00,Wager,,-10.0,937.56
Draftkings,2022-05-05 18:30:00,Wager,,-10.0,927.56
Draftkings,2022-05-06 17:15:00,Wager,,-10.0,917.56
Draftkings,2022-05-06 17:21:00,Wager,,-6.0,911.56
Draftkings,2022-05-07 17:29:00,Wager,,-10.0,901.56
Draftkings,2022-05-07 17:31:00,Wager,,-7.0,894.56
Draftkings,2022-05-08 11:44:00,Wager,,-10.0,884.56
Draftkings,2022-05-08 11:45:00,Wager,,-7.0,877.56
Draftkings,2022-05-08 18:30:00,Winnings,,26.5,904.06
Draftkings,2022-05-09 07:57:00,Wager,,-7.0,897.06
Draftkings,2022-05-09 07:58:00,Wager,,-10.0,887.06
Draftkings,2022-05-09 23:38:00,Winnings,,14.98,902.04
Draftkings,2022-05-10 17:13:00,Wager,,-20.0,882.04
Draftkings,2022-05-10 17:42:00,Wager,,-10.0,872.04
Draftkings,2022-05-10 17:45:00,Wager,,-7.0,865.04
Draftkings,2022-05-11 02:21:00,Winnings,,31.0,896.04
Draftkings,2022-05-11 16:04:00,Wager,,-7.0,889.04
Draftkings,2022-05-11 21:01:00,Winnings,,28.7,917.74
Draftkings,2022-05-12 10:32:00,Wager,,-6.0,911.74
Draftkings,2022-05-12 10:34:00,Wager,,-10.0,901.74
Draftkings,2022-05-12 20:48:00,Winnings,,22.0,923.74
Draftkings,2022-05-12 23:38:00,Winnings,,15.3,939.04
Draftkings,2022-05-13 11:09:00,Wager,,-4.04,935.0
Draftkings,2022-05-13 11:10:00,Wager,,-8.0,927.0
Draftkings,2022-05-13 11:11:00,Wager,,-5.0,922.0
Draftkings,2022-05-13 22:03:00,Winnings,,14.5,936.5
Draftkings,2022-05-15 15:06:00,Wager,,-10.0,926.5
Draftkings,2022-05-15 15:08:00,Wager,,-5.0,921.5
Draftkings,2022-05-17 15:01:00,Wager,,-20.0,901.5
Draftkings,2022-05-17 15:08:00,Wager,,-7.5,894.0
Draftkings,2022-05-17 15:10:00,Wager,,-4.0,890.0
Draftkings,2022-05-17 21:34:00,Winnings,,22.4,912.4
Draftkings,2022-05-18 12:58:00,Wager,,-9.0,903.4
Draftkings,2022-05-19 18:38:00,Wager,,-2.4,901.0
Draftkings,2022-05-19 18:42:00,Wager,,-8.0,893.0
Draftkings,2022-05-19 18:43:00,Wager,,-10.0,883.0
Draftkings,2022-05-20 14:53:00,Wager,,-3.0,880.0
Draftkings,2022-05-20 14:56:00,Wager,,-8.0,872.0
Draftkings,2022-05-21 20:25:00,Wager,,-12.0,860.0
Draftkings,2022-05-21 20:31:00,Wager,,-6.0,854.0
Draftkings,2022-05-21 20:35:00,Winnings,,6.0,860.0
Draftkings,2022-05-21 20:56:00,Winnings,,3.57,863.57
Draftkings,2022-05-21 22:19:00,Winnings,,22.43,886.0
Draftkings,2022-05-21 22:20:00,Winnings,,3.55,889.55
Draftkings,2022-05-21 23:09:00,Wager,,-4.55,885.0
Draftkings,2022-05-21 23:09:00,Wager,,4.55,889.55
Draftkings,2022-05-21 23:10:00,Wager,,-4.55,885.0
Draftkings,2022-05-23 18:31:00,Wager,,-10.0,875.0
Draftkings,2022-05-23 18:33:00,Wager,,-7.0,868.0
Draftkings,2022-05-23 23:57:00,Wager,,-5.0,863.0
Draftkings,2022-05-24 18:03:00,Wager,,-20.0,843.0
Draftkings,2022-05-24 18:04:00,Wager,,-10.0,833.0
Draftkings,2022-05-24 18:11:00,Wager,,-3.0,830.0
Draftkings,2022-05-25 18:02:00,Wager,,-10.0,820.0
Draftkings,2022-05-25 18:03:00,Wager,,-7.0,813.0
Draftkings,2022-05-26 17:34:00,Wager,,-8.0,805.0
Draftkings,2022-05-26 17:35:00,Wager,,-5.0,800.0
Draftkings,2022-05-26 23:32:00,Wager,,-7.0,793.0
Draftkings,2022-05-28 19:54:00,Wager,,-2.0,791.0
Draftkings,2022-05-28 19:55:00,Wager,,-3.0,788.0
Draftkings,2022-05-29 14:49:00,Wager,,-10.0,778.0
Draftkings,2022-05-30 20:31:00,Wager,,-5.0,773.0
Draftkings,2022-05-31 00:39:00,Winnings,,3.97,795.22
Draftkings,2022-05-31 00:39:00,Winnings,,18.25,791.25
Draftkings,2022-05-31 16:34:00,Wager,,-20.0,775.22
Draftkings,2022-06-02 18:22:00,Wager,,-15.0,765.7
Draftkings,2022-06-02 18:24:00,Wager,,-10.0,755.7
Draftkings,2022-06-02 18:30:00,Wager,,-4.0,751.7
Draftkings,2022-06-02 18:31:00,Wager,,-5.0,746.7
Draftkings,2022-06-03 11:15:00,Winnings,Bonus,24.38,771.08
Draftkings,2022-06-03 12:58:00,Wager,,-6.0,765.08
Draftkings,2022-06-03 13:10:00,Wager,,-3.0,762.08
Draftkings,2022-06-03 16:46:00,Winnings,,1.5,772.58
Draftkings,2022-06-03 16:46:00,Winnings,,9.0,771.08
Draftkings,2022-06-04 14:27:00,Wager,,-6.0,766.58
Draftkings,2022-06-04 14:28:00,Wager,,-1.0,765.58
Draftkings,2022-06-04 14:28:00,Wager,,1.0,766.58
Draftkings,2022-06-06 16:57:00,Wager,,-5.0,761.58
Draftkings,2022-06-06 16:57:00,Wager,,-10.0,751.58
Draftkings,2022-06-07 16:04:00,Wager,,-20.0,731.58
Draftkings,2022-06-07 16:06:00,Wager,,-10.0,721.58
Draftkings,2022-06-08 18:28:00,Wager,,-0.58,721.0
Draftkings,2022-06-08 23:46:00,Winnings,,2.17,723.17
Draftkings,2022-06-11 13:19:00,Wager,,-10.0,713.17
Draftkings,2022-06-11 13:24:00,Wager,,-20.0,693.17
Draftkings,2022-06-12 09:22:00,Wager,,-10.0,683.17
Draftkings,2022-06-12 16:39:00,Winnings,,10.0,693.17
Draftkings,2022-06-12 22:26:00,Wager,,-3.17,690.0
Draftkings,2022-06-13 14:30:00,Wager,,-5.0,685.0
Draftkings,2022-06-13 20:13:00,Winnings,,25.0,710.0
Draftkings,2022-06-14 08:09:00,Wager,,-10.0,700.0
Draftkings,2022-06-15 22:28:00,Winnings,,25.0,725.0
Draftkings,2022-06-21 17:25:00,Wager,,-10.0,715.0
Draftkings,2022-06-21 22:39:00,Winnings,,27.0,742.0
Draftkings,2022-06-22 10:06:00,Wager,,-10.0,732.0
Draftkings,2022-06-22 10:10:00,Wager,,-2.0,730.0
Draftkings,2022-06-22 23:34:00,Winnings,,33.0,763.0
Draftkings,2022-06-23 13:05:00,Wager,,-10.0,753.0
Draftkings,2022-06-26 11:24:00,Wager,,-3.0,750.0
Draftkings,2022-07-01 08:33:00,Wager,,-5.0,745.0
Draftkings,2022-07-04 19:23:00,Wager,,-10.0,735.0
Draftkings,2022-07-04 19:24:00,Wager,,-10.0,725.0
Draftkings,2022-07-09 10:50:00,Wager,,-10.0,715.0
Draftkings,2022-07-13 18:39:00,Wager,,-5.0,710.0
Draftkings,2022-07-19 22:25:00,Wager,,-2.0,708.0
Draftkings,2022-07-25 19:35:00,Wager,,-5.0,703.0
Draftkings,2022-07-28 19:16:00,Wager,,-8.0,695.0
Draftkings,2022-07-28 23:56:00,Winnings,,5.0,728.0
Draftkings,2022-07-28 23:56:00,Winnings,,28.0,723.0
Draftkings,2022-07-30 13:30:00,Wager,,-20.0,708.0
Draftkings,2022-08-01 10:56:00,Wager,,-6.0,702.0
Draftkings,2022-08-02 19:11:00,Wager,,-5.0,697.0
Draftkings,2022-08-17 22:31:00,Wager,,-3.0,694.0
Draftkings,2022-09-03 10:22:00,Wager,,-10.0,684.0
Draftkings,2022-09-03 10:24:00,Wager,,-7.0,677.0
Draftkings,2022-09-03 21:54:00,Winnings,,28.5,705.5
Draftkings,2022-09-03 21:57:00,Winnings,,9.25,714.75
Draftkings,2022-09-03 23:23:00,Winnings,,9.02,723.77
Draftkings,2022-09-03 23:23:00,Winnings,,25.04,748.81
Draftkings,2022-09-04 00:05:00,Wager,,-20.0,728.81
Draftkings,2022-09-08 18:57:00,Wager,,-10.0,718.81
Draftkings,2022-09-08 19:21:00,Wager,,-1.81,717.0
Draftkings,2022-09-09 18:51:00,Wager,,-5.0,712.0
Draftkings,2022-09-09 18:56:00,Wager,,-12.0,700.0
Draftkings,2022-09-09 18:57:00,Wager,,-3.0,697.0
Draftkings,2022-09-09 22:12:00,Winnings,,5.6,702.6
Draftkings,2022-09-09 22:13:00,Winnings,,0.66,703.26
Draftkings,2022-09-10 16:45:00,Wager,,-10.0,693.26
Draftkings,2022-09-10 16:48:00,Wager,,-5.0,688.26
Draftkings,2022-09-10 16:52:00,Wager,,-5.26,683.0
Draftkings,2022-09-10 16:53:00,Wager,,-3.0,680.0
Draftkings,2022-09-10 21:34:00,Winnings,,20.0,700.0
Draftkings,2022-09-10 21:34:00,Winnings,,3.3,703.3
Draftkings,2022-09-10 22:49:00,Winnings,,2.19,719.51
Draftkings,2022-09-10 22:49:00,Winnings,,14.02,717.32
Draftkings,2022-09-11 11:22:00,Wager,,-5.0,714.51
Draftkings,2022-09-11 15:45:00,Winnings,,5.0,719.51
Draftkings,2022-09-11 18:39:00,Wager,,-1.51,718.0
Draftkings,2022-09-11 18:42:00,Wager,,-8.0,710.0
Draftkings,2022-09-12 18:30:00,Wager,,-10.0,700.0
Draftkings,2022-09-17 16:19:00,Wager,,-15.0,685.0
Draftkings,2022-09-17 16:22:00,Wager,,-10.0,675.0
Draftkings,2022-09-17 17:18:00,Winnings,,10.0,685.0
Draftkings,2022-09-18 11:04:00,Wager,,-3.0,682.0
Draftkings,2022-09-19 18:09:00,Wager,,-7.0,675.0
Draftkings,2022-09-19 18:11:00,Wager,,-2.0,673.0
Draftkings,2022-09-19 23:59:00,Winnings,,24.81,697.81
Draftkings,2022-09-19 23:59:00,Winnings,,5.6,703.41
Draftkings,2022-09-22 11:22:00,Wager,,-10.0,693.41
Draftkings,2022-09-22 11:28:00,Wager,,-10.0,683.41
Draftkings,2022-09-22 11:36:00,Wager,,-6.41,677.0
Draftkings,2022-09-22 19:43:00,Winnings,,15.55,692.55
Draftkings,2022-09-25 09:53:00,Wager,,-10.0,682.55
Draftkings,2022-09-25 09:54:00,Wager,,-1.55,681.0
Draftkings,2022-09-25 09:58:00,Wager,,-2.0,679.0
Draftkings,2022-09-25 15:48:00,Winnings,,9.75,718.25
Draftkings,2022-09-25 15:48:00,Winnings,,29.5,708.5
Draftkings,2022-09-26 15:53:00,Wager,,-7.0,711.25
Draftkings,2022-09-26 16:03:00,Wager,,-7.25,704.0
Draftkings,2022-09-26 21:18:00,Winnings,,9.8,713.8
Draftkings,2022-09-26 21:21:00,Winnings,,4.2,718.0
Draftkings,2022-09-26 21:24:00,Wager,,-3.0,715.0
Draftkings,2022-09-29 18:15:00,Wager,,-5.0,710.0
Draftkings,2022-09-29 18:16:00,Wager,,-10.0,700.0
Draftkings,2022-09-29 18:16:00,Winnings,,10.0,710.0
Draftkings,2022-09-29 18:16:00,Wager,,-10.0,700.0
Draftkings,2022-09-29 18:58:00,Wager,,-10.0,690.0
Draftkings,2022-09-29 22:41:00,Winnings,,45.0,735.0
Draftkings,2022-09-29 22:41:00,Winnings,,10.5,745.5
Draftkings,2022-10-01 11:08:00,Wager,,-4.5,741.0
Draftkings,2022-10-01 22:28:00,Winnings,,12.6,753.6
Draftkings,2022-10-01 22:29:00,Winnings,,2.67,756.27
Draftkings,2022-10-02 11:56:00,Wager,,-1.27,755.0
Draftkings,2022-10-02 11:59:00,Wager,,-4.0,751.0
Draftkings,2022-10-02 19:19:00,Wager,,-3.0,748.0
Draftkings,2022-10-02 20:55:00,Wager,,-2.0,746.0
Draftkings,2022-10-03 16:58:00,Wager,,-5.0,741.0
Draftkings,2022-10-03 17:02:00,Wager,,-6.0,735.0
Draftkings,2022-10-06 13:54:00,Wager,,-1.0,729.0
Draftkings,2022-10-06 19:42:00,Winnings,,14.44,743.44
Draftkings,2022-10-06 19:43:00,Winnings,,5.56,749.0
Draftkings,2022-10-06 21:15:00,Wager,,-1.0,748.0
Draftkings,2022-10-07 11:01:00,Wager,,-5.0,743.0
Draftkings,2022-10-07 17:45:00,Wager,,-3.0,740.0
Draftkings,2022-10-07 17:46:00,Wager,,-7.0,733.0
Draftkings,2022-10-07 17:47:00,Wager,,-1.0,732.0
Draftkings,2022-10-07 21:07:00,Wager,,-3.0,729.0
Draftkings,2022-10-09 11:44:00,Wager,,-2.0,727.0
Draftkings,2022-10-09 11:47:00,Wager,,-8.0,719.0
Draftkings,2022-10-09 11:49:00,Wager,,-1.0,718.0
Draftkings,2022-10-09 11:56:00,Wager,,-4.0,714.0
Draftkings,2022-10-09 12:07:00,Winnings,,5.22,719.22
Draftkings,2022-10-09 12:08:00,Winnings,,1.38,720.6
Draftkings,2022-10-09 15:16:00,Wager,,-1.6,719.0
Draftkings,2022-10-09 15:28:00,Winnings,,13.4,732.4
Draftkings,2022-10-09 15:28:00,Winnings,,3.76,736.16
Draftkings,2022-10-10 18:56:00,Wager,,-6.16,730.0
Draftkings,2022-10-10 20:51:00,Wager,,-5.0,725.0
Draftkings,2022-10-11 12:29:00,Wager,,-2.0,723.0
Draftkings,2022-10-11 12:38:00,Wager,,-10.0,713.0
Draftkings,2022-10-11 12:40:00,Wager,,-5.0,708.0
Draftkings,2022-10-11 21:08:00,Winnings,,15.75,723.75
Draftkings,2022-10-11 21:08:00,Winnings,,3.54,727.29
Draftkings,2022-10-12 10:06:00,Wager,,-3.0,724.29
Draftkings,2022-10-12 19:30:00,Wager,,-3.0,721.29
Draftkings,2022-10-12 19:32:00,Wager,,-6.29,715.0
Draftkings,2022-10-13 17:34:00,Wager,,-25.0,690.0
Draftkings,2022-10-13 17:53:00,Wager,,-6.0,684.0
Draftkings,2022-10-13 18:16:00,Wager,,-20.0,664.0
Draftkings,2022-10-13 21:09:00,Wager,,-10.0,654.0
Draftkings,2022-10-13 22:07:00,Winnings,,45.83,699.83
Draftkings,2022-10-13 22:08:00,Winnings,,18.0,717.83
Draftkings,2022-10-14 14:25:00,Wager,,-10.0,707.83
Draftkings,2022-10-16 11:20:00,Wager,,-5.0,702.83
Draftkings,2022-10-16 11:21:00,Wager,,-5.83,697.0
Draftkings,2022-10-16 11:22:00,Wager,,-7.0,690.0
Draftkings,2022-10-16 15:13:00,Winnings,,20.44,710.44
Draftkings,2022-10-16 15:33:00,Wager,,-10.44,700.0
Draftkings,2022-10-16 16:28:00,Wager,,-1.5,698.5
Draftkings,2022-10-16 22:39:00,Winnings,,9.71,708.21
Draftkings,2022-10-16 22:39:00,Winnings,,1.95,710.16
Draftkings,2022-10-17 12:06:00,Wager,,-10.0,700.16
Draftkings,2022-10-17 12:09:00,Wager,,-10.0,690.16
Draftkings,2022-10-17 12:15:00,Wager,,-3.16,687.0
Draftkings,2022-10-17 20:50:00,Winnings,,10.0,697.0
Draftkings,2022-10-17 20:58:00,Winnings,,3.16,700.16
Draftkings,2022-10-18 21:30:00,Wager,,-10.0,690.16
Draftkings,2022-10-19 19:56:00,Wager,,-3.13,687.03
Draftkings,2022-10-19 19:58:00,Wager,,-6.0,681.03
Draftkings,2022-10-19 20:01:00,Wager,,-10.0,671.03
Draftkings,2022-10-19 20:18:00,Winnings,,11.0,682.03
Draftkings,2022-10-19 20:22:00,Winnings,,9.0,691.03
Draftkings,2022-10-19 21:07:00,Winnings,,9.39,700.42
Draftkings,2022-10-19 21:08:00,Winnings,,2.06,702.48
Draftkings,2022-10-20 17:12:00,Wager,,-10.0,692.48
Draftkings,2022-10-20 17:13:00,Wager,,-0.48,692.0
Draftkings,2022-10-20 17:16:00,Wager,,-7.0,685.0
Draftkings,2022-10-21 12:04:00,Wager,,-10.0,675.0
Draftkings,2022-10-21 12:06:00,Wager,,-10.0,665.0
Draftkings,2022-10-21 12:07:00,Wager,,-3.0,662.0
Draftkings,2022-10-21 18:42:00,Wager,,-4.0,658.0
Draftkings,2022-10-21 19:56:00,Winnings,,3.03,677.09
Draftkings,2022-10-21 19:56:00,Winnings,,16.06,674.06
Draftkings,2022-10-21 22:40:00,Winnings,,12.3,719.89
Draftkings,2022-10-21 22:40:00,Winnings,,30.5,707.59
Draftkings,2022-10-22 14:38:00,Winnings,,1.0,728.89
Draftkings,2022-10-22 14:38:00,Winnings,,8.0,727.89
Draftkings,2022-10-22 16:41:00,Wager,,-8.89,720.0
Draftkings,2022-10-22 16:53:00,Wager,,-7.0,713.0
Draftkings,2022-10-22 16:57:00,Wager,,-10.0,703.0
Draftkings,2022-10-22 17:25:00,Wager,,-10.0,693.0
Draftkings,2022-10-22 22:05:00,Winnings,,2.02,711.99
Draftkings,2022-10-22 22:05:00,Winnings,,16.97,709.97
Draftkings,2022-10-22 23:11:00,Wager,,-6.99,705.0
Draftkings,2022-10-23 00:51:00,Winnings,,13.34,718.34
Draftkings,2022-10-23 00:51:00,Winnings,,3.18,721.52
Draftkings,2022-10-23 12:01:00,Wager,,-21.52,700.0
Draftkings,2022-10-23 12:09:00,Wager,,-6.0,694.0
Draftkings,2022-10-23 16:10:00,Wager,,-4.0,690.0
Draftkings,2022-10-23 18:03:00,Wager,,-4.0,686.0
Draftkings,2022-10-23 18:33:00,Winnings,,55.49,741.49
Draftkings,2022-10-23 18:35:00,Winnings,,16.99,758.48
Draftkings,2022-10-23 21:45:00,Winnings,,11.11,769.59
Draftkings,2022-10-23 21:47:00,Winnings,,2.89,772.48
Draftkings,2022-10-24 18:57:00,Wager,,-20.0,752.48
Draftkings,2022-10-24 19:02:00,Wager,,-12.0,740.48
Draftkings,2022-10-24 19:06:00,Wager,,-6.48,734.0
Draftkings,2022-10-24 19:09:00,Wager,,-3.0,731.0
Draftkings,2022-10-24 22:40:00,Winnings,,4.56,744.26
Draftkings,2022-10-24 22:40:00,Winnings,,8.7,739.7
Draftkings,2022-10-25 19:06:00,Wager,,-8.26,736.0
Draftkings,2022-10-25 19:20:00,Wager,,-10.0,726.0
Draftkings,2022-10-26 06:26:00,Winnings,,25.88,751.88
Draftkings,2022-10-26 06:26:00,Winnings,,5.0,756.88
Draftkings,2022-10-26 20:03:00,Wager,,-10.0,746.88
Draftkings,2022-10-26 20:06:00,Wager,,-6.88,740.0
Draftkings,2022-10-26 22:47:00,Wager,,-10.0,730.0
Draftkings,2022-10-26 23:29:00,Winnings,,16.16,746.16
Draftkings,2022-10-26 23:29:00,Winnings,,3.07,749.23
Draftkings,2022-10-27 18:15:00,Wager,,-7.0,742.23
Draftkings,2022-10-27 18:23:00,Wager,,-7.23,735.0
Draftkings,2022-10-27 18:26:00,Wager,,-5.0,730.0
Draftkings,2022-10-27 22:21:00,Winnings,,2.1,747.5
Draftkings,2022-10-27 22:21:00,Winnings,,15.4,745.4
Draftkings,2022-10-27 22:42:00,Winnings,,22.62,777.81
Draftkings,2022-10-27 22:42:00,Winnings,,7.69,755.19
Draftkings,2022-10-28 18:33:00,Wager,,-2.81,775.0
Draftkings,2022-10-28 18:37:00,Wager,,-8.0,767.0
Draftkings,2022-10-29 10:08:00,Wager,,-5.0,762.0
Draftkings,2022-10-29 10:09:00,Wager,,-3.0,759.0
Draftkings,2022-10-29 10:12:00,Wager,,-4.0,755.0
Draftkings,2022-10-29 10:13:00,Wager,,-3.0,752.0
Draftkings,2022-10-29 10:16:00,Wager,,-7.0,745.0
Draftkings,2022-10-29 14:40:00,Winnings,,5.72,750.72
Draftkings,2022-10-29 14:40:00,Winnings,,0.68,751.4
Draftkings,2022-10-29 14:43:00,Wager,,-3.4,748.0
Draftkings,2022-10-29 14:45:00,Wager,,-3.0,745.0
Draftkings,2022-10-29 21:47:00,Winnings,,7.2,752.2
Draftkings,2022-10-29 21:48:00,Winnings,,1.26,753.46
Draftkings,2022-10-29 22:12:00,Winnings,,1.48,762.44
Draftkings,2022-10-29 22:12:00,Winnings,,7.5,760.96
Draftkings,2022-10-29 22:31:00,Winnings,,9.69,772.13
Draftkings,2022-10-29 22:31:00,Winnings,,4.08,776.21
Draftkings,2022-10-30 10:39:00,Wager,,-3.21,773.0
Draftkings,2022-10-30 10:40:00,Wager,,-2.0,771.0
Draftkings,2022-10-30 10:43:00,Wager,,-5.0,766.0
Draftkings,2022-10-30 10:53:00,Wager,,-10.0,756.0
Draftkings,2022-10-30 10:57:00,Wager,,-6.0,750.0
Draftkings,2022-10-30 11:03:00,Wager,,-3.0,747.0
Draftkings,2022-10-30 18:11:00,Winnings,,35.86,782.86
Draftkings,2022-10-30 18:12:00,Winnings,,12.94,795.8
Draftkings,2022-10-30 22:33:00,Winnings,,15.28,811.08
Draftkings,2022-10-30 22:33:00,Winnings,,2.57,813.65
Draftkings,2022-10-31 18:48:00,Wager,,-5.0,808.65
Draftkings,2022-10-31 18:49:00,Wager,,-5.0,803.65
Draftkings,2022-10-31 18:50:00,Wager,,-5.0,803.65
Draftkings,2022-10-31 18:50:00,Wager,,5.0,808.65
Draftkings,2022-10-31 18:50:00,Wager,,-5.0,803.65
Draftkings,2022-10-31 18:50:00,Wager,,5.0,808.65
Draftkings,2022-10-31 18:50:00,Wager,,5.0,808.65
Draftkings,2022-10-31 18:51:00,Wager,,-5.0,803.65
Draftkings,2022-10-31 18:54:00,Wager,,-3.65,800.0
Draftkings,2022-10-31 21:01:00,Winnings,,9.54,809.54
Draftkings,2022-10-31 21:02:00,Winnings,,1.5,811.04
Draftkings,2022-10-31 21:49:00,Winnings,,8.76,819.8
Draftkings,2022-10-31 21:50:00,Winnings,,3.32,823.12
Draftkings,2022-10-31 22:36:00,Winnings,,7.0,842.12
Draftkings,2022-10-31 22:36:00,Winnings,,12.0,835.12
Draftkings,2022-11-01 18:54:00,Wager,,-6.12,836.0
Draftkings,2022-11-01 18:55:00,Wager,,-6.0,830.0
Draftkings,2022-11-01 19:02:00,Wager,,-10.0,820.0
Draftkings,2022-11-01 19:11:00,Wager,,-7.0,813.0
Draftkings,2022-11-01 19:12:00,Wager,,-3.0,810.0
Draftkings,2022-11-01 21:36:00,Wager,,-4.0,806.0
Draftkings,2022-11-01 22:12:00,Winnings,,2.77,825.87
Draftkings,2022-11-01 22:12:00,Winnings,,17.1,823.1
Draftkings,2022-11-02 00:20:00,Winnings,,16.21,842.08
Draftkings,2022-11-02 00:20:00,Winnings,,2.53,844.61
Draftkings,2022-11-02 19:01:00,Wager,,-5.0,839.61
Draftkings,2022-11-02 19:06:00,Wager,,-10.0,829.61
Draftkings,2022-11-02 19:10:00,Wager,,-3.61,826.0
Draftkings,2022-11-03 18:16:00,Wager,,-10.0,816.0
Draftkings,2022-11-03 18:17:00,Wager,,-6.0,810.0
Draftkings,2022-11-03 18:18:00,Wager,,-11.0,799.0
Draftkings,2022-11-03 18:25:00,Wager,,-7.0,792.0
Draftkings,2022-11-03 18:27:00,Wager,,-2.0,790.0
Draftkings,2022-11-03 21:33:00,Winnings,,10.13,800.13
Draftkings,2022-11-03 21:34:00,Winnings,,1.87,802.0
Draftkings,2022-11-03 23:51:00,Winnings,,4.9,806.9
Draftkings,2022-11-03 23:51:00,Winnings,,0.87,807.77
Draftkings,2022-11-04 18:23:00,Wager,,-3.77,804.0
Draftkings,2022-11-05 14:36:00,Wager,,-10.0,794.0
Draftkings,2022-11-05 14:37:00,Wager,,-5.0,789.0
Draftkings,2022-11-05 20:43:00,Wager,,-6.0,783.0
Draftkings,2022-11-06 09:44:00,Wager,,-8.0,775.0
Draftkings,2022-11-06 09:45:00,Wager,,-2.0,773.0
Draftkings,2022-11-06 14:58:00,Winnings,,15.62,788.62
Draftkings,2022-11-06 16:24:00,Wager,,-20.0,768.62
Draftkings,2022-11-06 21:57:00,Winnings,,27.69,796.31
Draftkings,2022-11-06 21:59:00,Winnings,,12.31,808.62
Draftkings,2022-11-07 18:56:00,Wager,,-15.0,793.62
Draftkings,2022-11-07 19:00:00,Wager,,-5.0,788.62
Draftkings,2022-11-07 19:01:00,Wager,,-1.62,787.0
Draftkings,2022-11-07 19:06:00,Wager,,-6.0,781.0
Draftkings,2022-11-07 22:25:00,Winnings,,11.25,792.25
Draftkings,2022-11-07 22:25:00,Winnings,,6.25,798.5
Draftkings,2022-11-08 21:14:00,Wager,,-20.0,778.5
Draftkings,2022-11-08 21:16:00,Wager,,-11.5,767.0
Draftkings,2022-11-08 21:18:00,Wager,,-4.0,763.0
Draftkings,2022-11-09 18:34:00,Wager,,-10.0,753.0
Draftkings,2022-11-09 20:30:00,Winnings,,27.82,780.82
Draftkings,2022-11-09 20:30:00,Winnings,,8.16,788.98
Draftkings,2022-11-10 16:57:00,Wager,,-4.98,784.0
Draftkings,2022-11-10 17:01:00,Wager,,-10.0,774.0
Draftkings,2022-11-10 17:02:00,Wager,,-4.0,770.0
Draftkings,2022-11-11 17:49:00,Wager,,-7.0,763.0
Draftkings,2022-11-11 17:51:00,Wager,,-10.0,753.0
Draftkings,2022-11-11 17:51:00,Wager,,-3.0,750.0
Draftkings,2022-11-11 17:55:00,Wager,,-4.0,746.0
Draftkings,2022-11-11 23:31:00,Winnings,,10.5,756.5
Draftkings,2022-11-11 23:32:00,Winnings,,3.5,760.0
Draftkings,2022-11-11 23:36:00,Winnings,,15.26,775.26
Draftkings,2022-11-11 23:36:00,Winnings,,2.63,777.89
Draftkings,2022-11-12 14:48:00,Wager,,-7.0,770.89
Draftkings,2022-11-12 14:49:00,Wager,,-3.89,767.0
Draftkings,2022-11-12 22:00:00,Winnings,,9.53,776.53
Draftkings,2022-11-13 02:05:00,Winnings,,1.41,777.94
Draftkings,2022-11-13 11:38:00,Wager,,-5.94,772.0
Draftkings,2022-11-13 11:40:00,Wager,,-2.0,770.0
Draftkings,2022-11-13 11:47:00,Wager,,-6.0,764.0
Draftkings,2022-11-15 18:56:00,Wager,,-10.0,754.0
Draftkings,2022-11-15 18:58:00,Wager,,-14.0,740.0
Draftkings,2022-11-15 19:01:00,Wager,,-4.0,736.0
Draftkings,2022-11-15 19:08:00,Wager,,-3.0,733.0
Draftkings,2022-11-15 23:23:00,Winnings,,32.2,765.2
Draftkings,2022-11-15 23:23:00,Winnings,,9.1,774.3
Draftkings,2022-11-16 18:11:00,Wager,,-10.0,764.3
Draftkings,2022-11-17 19:13:00,Wager,,-5.0,759.3
Draftkings,2022-11-17 19:17:00,Wager,,-6.0,753.3
Draftkings,2022-11-17 19:17:00,Wager,,6.0,759.3
Draftkings,2022-11-17 19:17:00,Wager,,-6.0,753.3
Draftkings,2022-11-17 20:29:00,Winnings,,8.44,761.74
Draftkings,2022-11-17 20:30:00,Winnings,,1.56,763.3
Draftkings,2022-11-17 22:52:00,Wager,,-7.3,756.0
Draftkings,2022-11-19 10:59:00,Wager,,-7.0,749.0
Draftkings,2022-11-19 11:03:00,Wager,,-15.0,734.0
Draftkings,2022-11-19 11:05:00,Wager,,-15.0,719.0
Draftkings,2022-11-19 22:06:00,Wager,,-7.0,712.0
Draftkings,2022-11-20 00:39:00,Wager,,-7.0,705.0
Draftkings,2022-11-20 00:58:00,Winnings,,1.92,719.75
Draftkings,2022-11-20 00:58:00,Winnings,,12.83,717.83
Draftkings,2022-11-20 12:29:00,Winnings,,35.25,755.0
Draftkings,2022-11-20 12:29:00,Winnings,,20.25,775.25
Draftkings,2022-11-20 15:03:00,Winnings,,20.91,796.16
Draftkings,2022-11-20 15:08:00,Winnings,,2.2,798.36
Draftkings,2022-11-20 15:08:00,Winnings,,8.4,806.76
Draftkings,2022-11-20 15:12:00,Winnings,,6.81,813.57
Draftkings,2022-11-20 15:32:00,Wager,,-2.57,811.0
Draftkings,2022-11-20 15:34:00,Winnings,,14.7,825.7
Draftkings,2022-11-20 15:34:00,Winnings,,7.7,833.4
Draftkings,2022-11-20 23:26:00,Wager,,-7.4,826.0
Draftkings,2022-11-21 17:18:00,Wager,,-3.0,823.0
Draftkings,2022-11-24 10:55:00,Wager,,-10.0,813.0
Draftkings,2022-11-24 10:59:00,Wager,,-8.0,805.0
Draftkings,2022-11-24 17:22:00,Wager,,-5.0,800.0
Draftkings,2022-11-24 17:26:00,Wager,,-15.0,785.0
Draftkings,2022-11-24 22:24:00,Winnings,,15.67,800.67
Draftkings,2022-11-24 22:48:00,Winnings,,18.0,818.67
Draftkings,2022-11-24 22:48:00,Winnings,,10.0,828.67
Draftkings,2022-11-25 13:02:00,Wager,,-5.67,823.0
Draftkings,2022-11-25 15:10:00,Wager,,-6.0,817.0
Draftkings,2022-11-26 00:01:00,Winnings,,16.5,833.5
Draftkings,2022-11-26 00:01:00,Winnings,,5.42,838.92
Draftkings,2022-11-26 00:44:00,Winnings,,13.5,852.42
Draftkings,2022-11-26 00:44:00,Winnings,,1.88,854.3
Draftkings,2022-11-26 00:49:00,Wager,,-6.3,848.0
Draftkings,2022-11-27 10:03:00,Wager,,-6.0,842.0
Draftkings,2022-11-27 10:05:00,Wager,,-4.0,838.0
Draftkings,2022-11-27 10:08:00,Wager,,-8.0,830.0
Draftkings,2022-11-27 15:04:00,Winnings,,7.8,851.6
Draftkings,2022-11-27 15:04:00,Winnings,,13.8,843.8
Draftkings,2022-11-27 16:24:00,Winnings,,16.8,868.4
Draftkings,2022-11-29 15:03:00,Winnings,,18.04,886.44
Draftkings,2022-11-29 19:51:00,Wager,,-2.44,884.0
Draftkings,2022-11-30 19:49:00,Wager,,-10.0,874.0
Draftkings,2022-12-01 18:47:00,Wager,,-10.0,864.0
Draftkings,2022-12-01 18:51:00,Wager,,-20.0,844.0
Draftkings,2022-12-01 19:00:00,Wager,,-4.0,840.0
Draftkings,2022-12-02 20:21:00,Wager,,-3.0,837.0
Draftkings,2022-12-03 12:31:00,Wager,,-7.0,830.0
Draftkings,2022-12-03 22:17:00,Winnings,,13.36,843.36
Draftkings,2022-12-03 22:17:00,Winnings,,2.1,845.46
Draftkings,2022-12-04 09:46:00,Wager,,-2.46,843.0
Draftkings,2022-12-04 15:16:00,Winnings,,11.5,854.5
Draftkings,2022-12-04 15:16:00,Winnings,,1.87,856.37
Draftkings,2022-12-04 15:20:00,Winnings,,24.54,880.91
Draftkings,2022-12-11 11:52:00,Wager,,-6.91,874.0
Draftkings,2022-12-11 11:55:00,Wager,,-10.0,864.0
Draftkings,2022-12-11 11:56:00,Winnings,,10.0,874.0
Draftkings,2022-12-11 11:57:00,Wager,,-10.0,864.0
Draftkings,2022-12-11 11:59:00,Wager,,-4.0,860.0
Draftkings,2022-12-11 11:59:00,Wager,,-2.0,858.0
Draftkings,2022-12-12 18:39:00,Wager,,-10.0,848.0
Draftkings,2022-12-15 20:48:00,Wager,,-4.0,844.0
Draftkings,2022-12-15 22:22:00,Winnings,,9.2,853.2
Draftkings,2022-12-15 22:22:00,Winnings,,2.6,855.8
Draftkings,2022-12-17 12:08:00,Wager,,-10.0,845.8
Draftkings,2022-12-17 12:10:00,Wager,,-5.8,840.0
Draftkings,2022-12-17 23:06:00,Wager,,-10.0,830.0
Draftkings,2022-12-17 23:10:00,Wager,,-15.0,815.0
Draftkings,2022-12-18 09:37:00,Wager,,-2.0,813.0
Draftkings,2022-12-18 15:43:00,Winnings,,21.5,834.5
Draftkings,2022-12-18 17:53:00,Winnings,,18.69,853.19
Draftkings,2022-12-18 17:53:00,Winnings,,3.81,857.0
Draftkings,2022-12-18 18:33:00,Winnings,,24.28,881.28
Draftkings,2022-12-18 19:02:00,Wager,,-15.28,866.0
Draftkings,2022-12-21 18:17:00,Wager,,-4.0,862.0
Draftkings,2022-12-23 21:10:00,Wager,,-10.0,852.0
Draftkings,2022-12-23 21:14:00,Wager,,-10.0,842.0
Draftkings,2022-12-23 21:16:00,Wager,,-10.0,832.0
Draftkings,2022-12-24 09:38:00,Wager,,-7.0,825.0
Draftkings,2022-12-24 15:37:00,Winnings,,18.9,843.9
Draftkings,2022-12-24 15:37:00,Winnings,,3.57,847.47
Draftkings,2022-12-25 15:36:00,Wager,,-5.0,842.47
Draftkings,2022-12-25 15:38:00,Wager,,-10.0,832.47
Draftkings,2022-12-25 18:57:00,Winnings,,23.0,855.47
Draftkings,2022-12-25 18:57:00,Winnings,,6.5,861.97
Draftkings,2022-12-29 19:17:00,Wager,,-8.0,853.97
Draftkings,2022-12-29 19:17:00,Wager,,-8.0,853.97
Draftkings,2022-12-29 19:17:00,Wager,,8.0,861.97
Draftkings,2022-12-30 21:56:00,Wager,,-6.97,847.0
Draftkings,2022-12-30 21:57:00,Wager,,-10.0,837.0
Draftkings,2022-12-31 09:59:00,Wager,,-10.0,827.0
Draftkings,2022-12-31 10:00:00,Wager,,-10.0,817.0
Draftkings,2022-12-31 19:05:00,Winnings,,19.09,836.09
Draftkings,2022-12-31 19:11:00,Winnings,,4.54,840.63
Draftkings,2022-12-31 20:24:00,Winnings,,6.13,869.03
Draftkings,2022-12-31 20:24:00,Winnings,,22.27,862.9
Draftkings,2023-01-01 09:32:00,Wager,,-10.0,859.03
Draftkings,2023-01-01 09:34:00,Wager,,-2.03,857.0
Draftkings,2023-01-01 09:40:00,Wager,,-7.0,850.0
Draftkings,2023-01-01 09:43:00,Wager,,-6.0,844.0
Draftkings,2023-01-01 11:55:00,Wager,,-1.0,843.0
Draftkings,2023-01-01 11:55:00,Wager,,-5.0,838.0
Draftkings,2023-01-01 11:56:00,Wager,,-4.0,834.0
Draftkings,2023-01-01 11:56:00,Wager,,-4.0,830.0
Draftkings,2023-01-03 20:47:00,Wager,,-6.0,824.0
Draftkings,2023-01-05 16:02:00,Wager,,-10.0,814.0
Draftkings,2023-01-05 16:03:00,Wager,,-5.0,809.0
Draftkings,2023-01-07 09:08:00,Wager,,-5.0,804.0
Draftkings,2023-01-07 09:08:00,Wager,,-6.0,798.0
Draftkings,2023-01-08 11:54:00,Wager,,-1.0,797.0
Draftkings,2023-01-08 21:19:00,Winnings,,8.0,805.0
Draftkings,2023-01-08 21:19:00,Winnings,,2.0,807.0
Draftkings,2023-01-12 19:03:00,Wager,,-10.0,797.0
Draftkings,2023-01-14 14:40:00,Wager,,-7.0,790.0
Draftkings,2023-01-14 14:42:00,Wager,,-10.0,780.0
Draftkings,2023-01-14 14:42:00,Wager,,-10.0,770.0
Draftkings,2023-01-14 15:59:00,Winnings,,16.89,786.89
Draftkings,2023-01-14 16:01:00,Winnings,,3.11,790.0
Draftkings,2023-01-14 17:49:00,Winnings,,32.5,822.5
Draftkings,2023-01-15 21:56:00,Wager,,-10.0,812.5
Draftkings,2023-01-15 22:18:00,Winnings,,18.0,830.5
Draftkings,2023-01-16 14:29:00,Wager,,-10.0,820.5
Draftkings,2023-01-16 14:32:00,Wager,,-10.0,810.5
Draftkings,2023-01-16 14:34:00,Wager,,-10.0,800.5
Draftkings,2023-01-16 15:53:00,Winnings,,15.55,816.05
Draftkings,2023-01-16 15:53:00,Winnings,,1.83,817.88
Draftkings,2023-01-16 22:28:00,Winnings,,16.66,834.54
Draftkings,2023-01-16 22:29:00,Winnings,,3.34,837.88
Draftkings,2023-01-21 15:13:00,Wager,,-7.88,830.0
Draftkings,2023-01-21 15:13:00,Wager,,7.88,837.88
Draftkings,2023-01-21 15:14:00,Wager,,-10.0,827.88
Draftkings,2023-01-21 15:16:00,Wager,,-6.88,821.0
Draftkings,2023-01-21 17:05:00,Winnings,,14.1,835.1
Draftkings,2023-01-21 17:05:00,Winnings,,3.61,838.71
Draftkings,2023-01-21 19:46:00,Winnings,,16.66,855.37
Draftkings,2023-01-21 19:50:00,Winnings,,3.34,858.71
Draftkings,2023-01-22 11:44:00,Wager,,-7.71,851.0
Draftkings,2023-01-22 11:47:00,Wager,,-7.0,844.0
Draftkings,2023-01-22 11:48:00,Wager,,-10.0,834.0
Draftkings,2023-01-22 11:49:00,Wager,,-2.0,832.0
Draftkings,2023-01-22 11:50:00,Wager,,-2.0,830.0
Draftkings,2023-01-22 14:07:00,Winnings,,4.5,834.5
Draftkings,2023-01-22 14:09:00,Winnings,,1.0,835.5
Draftkings,2023-01-22 20:47:00,Winnings,,25.0,860.5
Draftkings,2023-01-26 00:55:00,Wager,,-14.5,846.0
Draftkings,2023-01-26 20:01:00,Wager,,-5.0,841.0
Draftkings,2023-01-26 22:16:00,Winnings,,14.5,855.5
Draftkings,2023-01-27 13:03:00,Wager,,-10.0,845.5
Draftkings,2023-01-27 13:09:00,Wager,,-15.0,830.5
Draftkings,2023-01-27 13:10:00,Wager,,-10.0,820.5
Draftkings,2023-01-27 21:43:00,Winnings,,44.25,864.75
Draftkings,2023-01-27 21:43:00,Winnings,,29.25,894.0
Draftkings,2023-01-27 23:20:00,Winnings,,19.71,913.71
Draftkings,2023-01-27 23:20:00,Winnings,,4.85,918.56
Draftkings,2023-01-28 09:46:00,Wager,,-5.56,913.0
Draftkings,2023-01-28 09:51:00,Wager,,-15.0,898.0
Draftkings,2023-01-28 09:55:00,Wager,,-11.0,887.0
Draftkings,2023-01-28 13:17:00,Wager,,-10.0,877.0
Draftkings,2023-01-28 15:08:00,Winnings,,18.69,895.69
Draftkings,2023-01-28 15:08:00,Winnings,,4.35,900.04
Draftkings,2023-01-28 21:19:00,Winnings,,33.0,933.04
Draftkings,2023-01-28 21:21:00,Winnings,,13.5,946.54
Draftkings,2023-01-28 23:06:00,Winnings,,9.14,955.68
Draftkings,2023-01-28 23:09:00,Winnings,,1.98,957.66
Draftkings,2023-01-29 10:04:00,Wager,,-10.0,947.66
Draftkings,2023-01-29 10:05:00,Wager,,-5.66,942.0
Draftkings,2023-01-29 10:06:00,Wager,,-2.0,940.0
Draftkings,2023-01-29 10:07:00,Wager,,-10.0,930.0
Draftkings,2023-01-29 12:22:00,Wager,,-4.0,926.0
Draftkings,2023-01-29 15:09:00,Winnings,,9.7,935.7
Draftkings,2023-01-29 15:13:00,Winnings,,4.45,940.15
Draftkings,2023-01-29 18:43:00,Winnings,,15.0,955.15
Draftkings,2023-01-29 18:44:00,Winnings,,4.0,959.15
Draftkings,2023-01-29 20:15:00,Winnings,,15.26,974.41
Draftkings,2023-01-29 20:21:00,Winnings,,4.74,979.15
Draftkings,2023-01-30 20:53:00,Wager,,-10.0,969.15
Draftkings,2023-01-30 20:56:00,Wager,,-6.15,963.0
Draftkings,2023-01-31 18:39:00,Wager,,-10.0,943.0
Draftkings,2023-01-31 18:39:00,Wager,,-10.0,953.0
Draftkings,2023-01-31 19:19:00,Winnings,,14.14,957.14
Draftkings,2023-01-31 20:53:00,Winnings,,11.66,968.8
Draftkings,2023-01-31 23:52:00,Winnings,,30.5,999.3
Draftkings,2023-02-01 18:39:00,Winnings,,22.9,1022.2
Draftkings,2023-02-01 19:47:00,Wager,,-10.0,1012.2
Draftkings,2023-02-01 19:48:00,Wager,,-10.0,1002.2
Draftkings,2023-02-01 20:28:00,Winnings,,17.4,1019.6
Draftkings,2023-02-02 19:32:00,Wager,,-10.0,1009.6
Draftkings,2023-02-02 19:33:00,Wager,,-11.0,998.6
Draftkings,2023-02-02 19:55:00,Winnings,,16.36,1014.96
Draftkings,2023-02-04 10:29:00,Wager,,-10.0,1004.96
Draftkings,2023-02-04 10:30:00,Wager,,-10.0,994.96
Draftkings,2023-02-04 19:32:00,Winnings,,14.87,1009.83
Draftkings,2023-02-07 12:08:00,Wager,,-1.0,1008.83
Draftkings,2023-02-07 12:14:00,Wager,,-10.0,998.83
Draftkings,2023-02-07 18:58:00,Wager,,-10.0,988.83
Draftkings,2023-02-07 23:50:00,Winnings,,2.05,990.88
Draftkings,2023-02-08 19:50:00,Wager,,-5.88,985.0
Draftkings,2023-02-08 19:53:00,Wager,,-10.0,975.0
Draftkings,2023-02-09 17:53:00,Wager,,-6.0,969.0
Draftkings,2023-02-09 19:54:00,Wager,,-10.0,959.0
Draftkings,2023-02-10 20:06:00,Wager,,-10.0,949.0
Draftkings,2023-02-10 20:07:00,Wager,,-3.0,946.0
Draftkings,2023-02-10 23:34:00,Winnings,,38.5,984.5
Draftkings,2023-02-11 09:58:00,Wager,,-10.0,974.5
Draftkings,2023-02-11 10:10:00,Wager,,-8.5,966.0
Draftkings,2023-02-12 12:07:00,Wager,,-10.0,956.0
Draftkings,2023-02-12 15:40:00,Winnings,,39.5,995.5
Draftkings,2023-02-12 21:04:00,Winnings,,10.28,1005.78
Draftkings,2023-02-12 21:16:00,Winnings,,24.27,1030.05
Draftkings,2023-02-13 19:23:00,Wager,,-10.0,1020.05
Draftkings,2023-02-13 23:31:00,Winnings,,36.0,1056.05
Draftkings,2023-02-14 18:49:00,Wager,,-10.0,1046.05
Draftkings,2023-02-15 19:24:00,Wager,,-10.0,1036.05
Draftkings,2023-02-15 22:26:00,Winnings,,37.0,1073.05
Draftkings,2023-02-18 12:06:00,Wager,,-15.0,1058.05
Draftkings,2023-02-18 15:49:00,Wager,,-11.0,1047.05
Draftkings,2023-02-18 17:18:00,Winnings,,20.16,1067.21
Draftkings,2023-02-18 17:18:00,Winnings,,4.59,1071.8
Draftkings,2023-02-19 11:59:00,Wager,,-6.0,1065.8
Draftkings,2023-02-19 13:23:00,Wager,,-10.0,1055.8
Draftkings,2023-02-19 14:02:00,Winnings,,4.54,1079.43
Draftkings,2023-02-19 14:02:00,Winnings,,19.09,1074.89
Draftkings,2023-02-19 14:42:00,Wager,,-10.0,1069.43
Draftkings,2023-02-19 21:54:00,Winnings,,22.5,1091.93
Draftkings,2023-02-19 21:55:00,Winnings,,3.12,1095.05
Draftkings,2023-02-20 19:08:00,Wager,,-3.0,1092.05
Draftkings,2023-02-21 19:50:00,Wager,,-10.0,1082.05
Draftkings,2023-02-21 19:56:00,Wager,,-4.0,1078.05
Draftkings,2023-02-21 22:34:00,Winnings,,11.8,1089.85
Draftkings,2023-02-24 20:05:00,Wager,,-10.0,1079.85
Draftkings,2023-02-24 23:48:00,Winnings,,36.5,1116.35
Draftkings,2023-02-25 18:15:00,Wager,,-10.0,1106.35
Draftkings,2023-02-25 20:06:00,Wager,,-5.0,1101.35
Draftkings,2023-02-27 08:29:00,Wager,,-10.0,1091.35
Draftkings,2023-02-28 10:02:00,Wager,,-10.0,1081.35
Draftkings,2023-02-28 21:37:00,Winnings,,35.5,1116.85
Draftkings,2023-03-01 12:49:00,Wager,,-10.0,1106.85
Draftkings,2023-03-01 12:51:00,Wager,,-10.0,1096.85
Draftkings,2023-03-01 20:19:00,Winnings,,16.25,1113.1
Draftkings,2023-03-01 20:19:00,Winnings,,3.75,1116.85
Draftkings,2023-03-01 20:55:00,Wager,,-10.0,1106.85
Draftkings,2023-03-01 20:55:00,Wager,,10.0,1116.85
Draftkings,2023-03-01 20:56:00,Wager,,-10.0,1106.85
Draftkings,2023-03-02 09:03:00,Wager,,-10.0,1096.85
Draftkings,2023-03-02 22:25:00,Wager,,-10.0,1086.85
Draftkings,2023-03-03 00:15:00,Winnings,,16.06,1102.91
Draftkings,2023-03-03 00:16:00,Winnings,,2.0,1104.91
Draftkings,2023-03-03 12:50:00,Wager,,-15.0,1089.91
Draftkings,2023-03-03 15:36:00,Wager,,-10.0,1079.91
Draftkings,2023-03-04 19:24:00,Wager,,-10.0,1069.91
Draftkings,2023-03-04 19:24:00,Wager,,-7.0,1062.91
Draftkings,2023-03-04 21:09:00,Wager,,-10.0,1052.91
Draftkings,2023-03-05 14:05:00,Wager,,-10.0,1042.91
Draftkings,2023-03-05 18:02:00,Winnings,,19.69,1062.6
Draftkings,2023-03-06 15:53:00,Wager,,-10.0,1052.6
Draftkings,2023-03-07 20:48:00,Wager,,-10.0,1042.6
Draftkings,2023-03-07 23:40:00,Winnings,,41.0,1083.6
Draftkings,2023-03-08 09:07:00,Wager,,-2.0,1071.6
Draftkings,2023-03-08 09:07:00,Wager,,-10.0,1073.6
Draftkings,2023-03-08 18:56:00,Wager,,-10.0,1061.6
Draftkings,2023-03-08 21:13:00,Wager,,-10.0,1051.6
Draftkings,2023-03-08 22:24:00,Winnings,,20.5,1072.1
Draftkings,2023-03-09 10:44:00,Wager,,-10.0,1062.1
Draftkings,2023-03-09 15:36:00,Winnings,,24.03,1086.13
Draftkings,2023-03-09 19:42:00,Wager,,-5.0,1081.13
Draftkings,2023-03-09 21:18:00,Winnings,,33.0,1114.13
Draftkings,2023-03-10 12:04:00,Wager,,-3.0,1111.13
Draftkings,2023-03-10 13:24:00,Winnings,,14.48,1125.61
Draftkings,2023-03-10 13:25:00,Winnings,,1.9,1127.51
Draftkings,2023-03-10 13:58:00,Wager,,-15.0,1112.51
Draftkings,2023-03-10 14:03:00,Wager,,-10.0,1102.51
Draftkings,2023-03-10 14:07:00,Wager,,6.0,1102.51
Draftkings,2023-03-10 14:07:00,Wager,,-6.0,1096.51
Draftkings,2023-03-10 19:19:00,Wager,,-7.0,1095.51
Draftkings,2023-03-10 22:26:00,Wager,,-7.0,1088.51
Draftkings,2023-03-10 22:53:00,Winnings,,12.83,1101.34
Draftkings,2023-03-10 22:53:00,Winnings,,1.92,1103.26
Draftkings,2023-03-11 11:51:00,Wager,,-10.0,1093.26
Draftkings,2023-03-11 16:17:00,Winnings,,29.86,1123.12
Draftkings,2023-03-11 20:18:00,Winnings,,36.5,1159.62
Draftkings,2023-03-11 21:34:00,Wager,,-5.0,1154.62
Draftkings,2023-03-11 23:04:00,Winnings,,9.54,1164.16
Draftkings,2023-03-12 11:13:00,Wager,,-10.0,1154.16
Draftkings,2023-03-12 11:15:00,Wager,,-12.0,1142.16
Draftkings,2023-03-12 16:41:00,Winnings,,23.42,1165.58
Draftkings,2023-03-12 16:41:00,Winnings,,26.35,1191.93
Draftkings,2023-03-12 16:42:00,Winnings,,3.78,1195.71
Draftkings,2023-03-12 22:48:00,Winnings,,47.0,1242.71
Draftkings,2023-03-13 19:08:00,Wager,,-10.0,1232.71
Draftkings,2023-03-14 19:42:00,Wager,,-7.0,1225.71
Draftkings,2023-03-14 19:44:00,Wager,,-10.0,1215.71
Draftkings,2023-03-14 20:03:00,Winnings,,13.66,1229.37
Draftkings,2023-03-14 20:03:00,Winnings,,1.67,1231.04
Draftkings,2023-03-15 18:56:00,Wager,,-7.0,1224.04
Draftkings,2023-03-15 18:57:00,Wager,,-10.0,1214.04
Draftkings,2023-03-15 18:59:00,Wager,,-10.0,1204.04
Draftkings,2023-03-15 19:43:00,Winnings,,1.59,1218.99
Draftkings,2023-03-15 19:43:00,Winnings,,13.36,1217.4
Draftkings,2023-03-16 12:31:00,Wager,,-2.0,1216.99
Draftkings,2023-03-16 12:34:00,Wager,,-10.0,1206.99
Draftkings,2023-03-16 16:45:00,Winnings,,4.9,1211.89
Draftkings,2023-03-16 16:46:00,Winnings,,0.6,1212.49
Draftkings,2023-03-16 18:14:00,Wager,,-5.0,1207.49
Draftkings,2023-03-16 23:16:00,Winnings,,26.14,1233.63
Draftkings,2023-03-17 08:53:00,Wager,,-5.0,1228.63
Draftkings,2023-03-17 08:53:00,Wager,,-15.0,1213.63
Draftkings,2023-03-17 09:59:00,Wager,,-4.0,1209.63
Draftkings,2023-03-17 20:52:00,Winnings,,26.0,1235.63
Draftkings,2023-03-17 20:53:00,Winnings,,5.5,1241.13
Draftkings,2023-03-17 21:06:00,Winnings,,18.5,1259.63
Draftkings,2023-03-17 21:06:00,Winnings,,2.35,1261.98
Draftkings,2023-03-18 13:07:00,Wager,,-5.0,1256.98
Draftkings,2023-03-18 13:08:00,Wager,,-10.0,1246.98
Draftkings,2023-03-18 13:09:00,Wager,,-10.0,1236.98
Draftkings,2023-03-18 13:11:00,Wager,,-6.0,1230.98
Draftkings,2023-03-18 14:44:00,Winnings,,1.22,1240.9
Draftkings,2023-03-18 14:44:00,Winnings,,8.7,1239.68
Draftkings,2023-03-18 16:14:00,Winnings,,21.71,1262.61
Draftkings,2023-03-18 17:11:00,Wager,,-10.0,1252.61
Draftkings,2023-03-18 17:11:00,Wager,,-0.61,1252.0
Draftkings,2023-03-18 21:17:00,Winnings,,20.43,1272.43
Draftkings,2023-03-18 21:17:00,Winnings,,4.61,1277.04
Draftkings,2023-03-19 10:25:00,Wager,,-6.0,1271.04
Draftkings,2023-03-19 18:44:00,Wager,,-6.0,1265.04
Draftkings,2023-03-19 18:44:00,Wager,,6.0,1271.04
Draftkings,2023-03-19 18:44:00,Wager,,-7.0,1264.04
Draftkings,2023-03-19 18:46:00,Wager,,-6.0,1258.04
Draftkings,2023-03-19 23:09:00,Winnings,,20.2,1278.24
Draftkings,2023-03-23 19:42:00,Wager,,-8.0,1270.24
Draftkings,2023-03-23 19:44:00,Wager,,-6.0,1264.24
Draftkings,2023-03-26 12:56:00,Wager,,-10.0,1254.24
Draftkings,2023-03-26 16:39:00,Wager,,-7.0,1247.24
Draftkings,2023-03-26 18:11:00,Wager,,-6.0,1241.24
Draftkings,2023-03-26 19:22:00,Winnings,,14.7,1255.94
Draftkings,2023-03-26 19:22:00,Winnings,,4.35,1260.29
Draftkings,2023-03-26 19:36:00,Winnings,,5.42,1289.16
Draftkings,2023-03-26 19:36:00,Winnings,,23.45,1283.74
Draftkings,2023-03-29 18:43:00,Wager,,-10.0,1279.16
Draftkings,2023-03-29 18:46:00,Wager,,-7.0,1272.16
Draftkings,2023-03-29 18:46:00,Wager,,7.0,1279.16
Draftkings,2023-03-29 18:47:00,Wager,,-7.0,1272.16
Draftkings,2023-03-29 18:47:00,Wager,,7.0,1279.16
Draftkings,2023-03-29 18:47:00,Wager,,-7.0,1272.16
Draftkings,2023-03-29 18:49:00,Wager,,-10.0,1262.16
Draftkings,2023-03-29 21:38:00,Winnings,,34.5,1296.66
Draftkings,2023-03-30 16:49:00,Wager,,-10.0,1286.66
Draftkings,2023-03-30 16:50:00,Wager,,-10.0,1276.66
Draftkings,2023-03-30 16:51:00,Wager,,-10.0,1266.66
Draftkings,2023-03-30 20:47:00,Winnings,,15.71,1282.37
Draftkings,2023-03-30 20:47:00,Winnings,,4.29,1286.66
Draftkings,2023-03-30 22:05:00,Winnings,,38.0,1324.66
Draftkings,2023-03-30 23:03:00,Winnings,,15.55,1340.21
Draftkings,2023-03-30 23:03:00,Winnings,,4.45,1344.66
Draftkings,2023-03-31 18:44:00,Wager,,-10.0,1334.66
Draftkings,2023-03-31 18:44:00,Wager,,-10.0,1324.66
Draftkings,2023-03-31 18:45:00,Wager,,-10.0,1314.66
Draftkings,2023-03-31 18:48:00,Wager,,-10.0,1304.66
Draftkings,2023-03-31 21:48:00,Winnings,,35.0,1339.66
Draftkings,2023-03-31 23:15:00,Winnings,,14.34,1354.0
Draftkings,2023-03-31 23:15:00,Winnings,,5.66,1359.66
Draftkings,2023-04-01 12:02:00,Wager,,-6.0,1353.66
Draftkings,2023-04-01 12:04:00,Wager,,-10.0,1343.66
Draftkings,2023-04-01 12:06:00,Wager,,-6.0,1337.66
Draftkings,2023-04-01 15:53:00,Winnings,,17.4,1355.06
Draftkings,2023-04-01 15:53:00,Winnings,,3.42,1358.48
Draftkings,2023-04-01 17:03:00,Winnings,,13.2,1371.68
Draftkings,2023-04-01 17:03:00,Winnings,,2.37,1374.05
Draftkings,2023-04-01 17:59:00,Winnings,,23.44,1397.49
Draftkings,2023-04-02 09:57:00,Wager,,-5.0,1392.49
Draftkings,2023-04-02 15:55:00,Winnings,,19.0,1411.49
Draftkings,2023-04-02 15:55:00,Winnings,,4.2,1415.69
Draftkings,2023-04-02 16:01:00,Wager,,-10.0,1405.69
Draftkings,2023-04-02 16:03:00,Wager,,-5.69,1400.0
Draftkings,2023-04-02 20:34:00,Winnings,,18.34,1418.34
Draftkings,2023-04-02 20:35:00,Winnings,,4.17,1422.51
Draftkings,2023-04-03 13:23:00,Wager,,-5.0,1417.51
Draftkings,2023-04-04 18:43:00,Wager,,-6.0,1411.51
Draftkings,2023-04-04 18:46:00,Wager,,-7.0,1404.51
Draftkings,2023-04-05 19:48:00,Wager,,-10.0,1394.51
Draftkings,2023-04-05 19:52:00,Wager,,-7.0,1387.51
Draftkings,2023-04-05 19:52:00,Wager,,7.0,1394.51
Draftkings,2023-04-05 19:53:00,Wager,,-7.0,1387.51
Draftkings,2023-04-05 19:53:00,Wager,,7.0,1394.51
Draftkings,2023-04-05 19:54:00,Wager,,-7.0,1387.51
Draftkings,2023-04-05 19:56:00,Wager,,-3.0,1384.51
Draftkings,2023-04-05 19:58:00,Wager,,-7.0,1377.51
Draftkings,2023-04-05 20:00:00,Winnings,,22.5,1400.01
Draftkings,2023-04-05 23:34:00,Winnings,,8.7,1408.71
Draftkings,2023-04-05 23:34:00,Winnings,,3.3,1412.01
Draftkings,2023-04-06 00:34:00,Wager,,-5.0,1407.01
Draftkings,2023-04-06 00:35:00,Wager,,-1.0,1406.01
Draftkings,2023-04-06 20:25:00,Wager,,-7.0,1399.01
Draftkings,2023-04-06 20:26:00,Wager,,-2.0,1397.01
Draftkings,2023-04-06 20:27:00,Wager,,-3.0,1394.01
Draftkings,2023-04-06 21:43:00,Winnings,,27.54,1421.55
Draftkings,2023-04-06 21:43:00,Winnings,,6.78,1428.33
Draftkings,2023-04-07 10:48:00,Wager,,-5.0,1423.33
Draftkings,2023-04-07 11:29:00,Wager,,-7.0,1416.33
Draftkings,2023-04-07 21:20:00,Wager,,-4.0,1412.33
Draftkings,2023-04-07 23:53:00,Winnings,,2.45,1428.58
Draftkings,2023-04-07 23:53:00,Winnings,,13.8,1426.13
Draftkings,2023-04-08 09:50:00,Winnings,,9.76,1438.34
Draftkings,2023-04-08 09:50:00,Winnings,,0.85,1439.19
Draftkings,2023-04-08 09:51:00,Wager,,-7.0,1432.19
Draftkings,2023-04-08 10:10:00,Wager,,-7.0,1425.19
Draftkings,2023-04-08 10:10:00,Wager,,-20.0,1405.19
Draftkings,2023-04-08 16:22:00,Wager,,-5.0,1400.19
Draftkings,2023-04-09 09:29:00,Wager,,-7.0,1393.19
Draftkings,2023-04-09 09:33:00,Wager,,-7.0,1386.19
Draftkings,2023-04-09 15:01:00,Wager,,-3.0,1383.19
Draftkings,2023-04-09 15:03:00,Wager,,-6.0,1377.19
Draftkings,2023-04-09 17:09:00,Winnings,,23.91,1401.1
Draftkings,2023-04-09 17:09:00,Winnings,,5.58,1406.68
Draftkings,2023-04-09 18:25:00,Winnings,,10.8,1417.48
Draftkings,2023-04-09 18:26:00,Winnings,,0.86,1418.34
