Book,Time,Action,Bonus,Change,Balance
Fanduel,2021-04-01 14:48:00,Deposit,,50.0,50.0
Fanduel,2021-04-01 15:11:00,Wager,,-5.0,45.0
Fanduel,2021-04-01 15:23:00,Winnings,Bonus,50.0,95.0
Fanduel,2021-04-01 15:29:00,Wager,,-10.0,85.0
Fanduel,2021-04-02 12:45:00,Winnings,Bonus,10.0,95.0
Fanduel,2021-04-03 23:23:00,Winnings,,5.45,100.45
Fanduel,2021-04-04 17:44:00,Wager,,-10.0,90.45
Fanduel,2021-04-05 11:09:00,Winnings,Bonus,10.0,100.45
Fanduel,2021-04-05 17:24:00,Wager,,-10.0,90.45
Fanduel,2021-04-05 23:30:00,Winnings,,26.8,117.25
Fanduel,2021-04-06 17:22:00,Winnings,Bonus,195.0,312.25
Fanduel,2021-04-08 11:57:00,Wager,,-5.0,307.25
Fanduel,2021-04-08 11:58:00,Wager,,-5.0,302.25
Fanduel,2021-04-08 19:23:00,Winnings,,10.8,313.05
Fanduel,2021-04-11 15:30:00,Wager,,-0.1,312.95
Fanduel,2021-04-17 20:56:00,Wager,,-6.85,306.1
Fanduel,2021-04-18 10:42:00,Wager,,-2.5,303.6
Fanduel,2021-04-18 16:47:00,Wager,,-5.0,298.6
Fanduel,2021-04-18 22:21:00,Winnings,,13.0,311.6
Fanduel,2021-04-19 17:23:00,Wager,,-2.0,309.6
Fanduel,2021-04-20 16:28:00,Wager,,-8.0,301.6
Fanduel,2021-04-24 11:25:00,Wager,,-5.0,296.6
Fanduel,2021-04-24 19:09:00,Winnings,,8.97,305.57
Fanduel,2021-04-26 14:31:00,Wager,,-5.0,300.57
Fanduel,2021-04-27 16:55:00,Wager,,-5.0,295.57
Fanduel,2021-04-27 23:11:00,Winnings,,9.1,304.67
Fanduel,2021-04-28 16:59:00,Wager,,-5.0,299.67
Fanduel,2021-04-28 21:34:00,Wager,,-5.0,294.67
Fanduel,2021-04-28 21:45:00,Winnings,,2.3,296.97
Fanduel,2021-04-28 23:07:00,Winnings,,13.25,310.22
Fanduel,2021-04-29 22:22:00,Wager,,-25.0,285.22
Fanduel,2021-04-29 22:24:00,Winnings,,25.0,310.22
Fanduel,2021-04-29 22:24:00,Wager,,-25.0,285.22
Fanduel,2021-04-29 22:24:00,Winnings,Bonus,10.0,295.22
Fanduel,2021-05-04 00:15:00,Wager,,-5.0,290.22
Fanduel,2021-05-04 20:27:00,Wager,,5.0,295.22
Fanduel,2021-05-06 11:35:00,Wager,,-5.0,290.22
Fanduel,2021-05-07 14:00:00,Wager,,-5.0,285.22
Fanduel,2021-05-11 15:40:00,Wager,,-5.0,280.22
Fanduel,2021-05-11 23:37:00,Winnings,,10.7,290.92
Fanduel,2021-05-12 16:24:00,Wager,,-5.0,285.92
Fanduel,2021-05-14 12:47:00,Wager,,-5.0,280.92
Fanduel,2021-05-14 14:32:00,Wager,,-2.0,278.92
Fanduel,2021-05-16 18:48:00,Wager,,-3.0,275.92
Fanduel,2021-05-19 18:56:00,Wager,,-10.0,265.92
Fanduel,2021-05-20 00:42:00,Winnings,Bonus,10.0,275.92
Fanduel,2021-05-21 12:52:00,Wager,,-5.0,270.92
Fanduel,2021-05-22 10:39:00,Wager,,-5.0,265.92
Fanduel,2021-05-22 22:04:00,Winnings,,9.63,275.55
Fanduel,2021-05-23 10:47:00,Wager,,-4.0,271.55
Fanduel,2021-05-23 15:45:00,Winnings,,7.64,279.19
Fanduel,2021-05-23 18:07:00,Winnings,,4.0,279.19
Fanduel,2021-05-23 18:07:00,Wager,,-4.0,275.19
Fanduel,2021-05-23 18:08:00,Wager,,-2.0,277.19
Fanduel,2021-05-25 11:24:00,Wager,,-5.0,272.19
Fanduel,2021-06-06 12:41:00,Wager,,-5,267.19
Fanduel,2021-06-12 09:43:00,Wager,,-15,252.19
Fanduel,2021-07-01 12:29:00,Wager,,-5.0,247.19
Fanduel,2021-07-09 16:31:00,Wager,,-2.0,245.19
Fanduel,2021-07-10 14:14:00,Wager,,-10.0,235.19
Fanduel,2021-07-11 00:32:00,Winnings,,17.94,253.13
Fanduel,2021-07-23 21:16:00,Wager,,-3.0,250.13
Fanduel,2021-08-23 12:34:00,Winnings,Bonus,-85.55,164.58
Fanduel,2021-08-26 10:59:00,Winnings,Bonus,5.0,169.58
Fanduel,2021-08-28 17:59:00,Wager,,-10.0,159.58
Fanduel,2021-08-28 18:01:00,Winnings,,10.0,169.58
Fanduel,2021-08-28 18:04:00,Wager,,-10.0,159.58
Fanduel,2021-08-28 21:02:00,Winnings,Bonus,10.0,169.58
Fanduel,2021-09-01 21:28:00,Wager,,-10.0,159.58
Fanduel,2021-09-02 11:55:00,Winnings,Bonus,-5.0,154.58
Fanduel,2021-09-04 22:50:00,Winnings,Bonus,10.0,164.58
Fanduel,2021-09-07 10:26:00,Wager,,-50.0,114.58
Fanduel,2021-09-07 10:31:00,Wager,,-10.0,104.58
Fanduel,2021-09-11 18:28:00,Winnings,Bonus,150.0,254.58
Fanduel,2021-09-12 23:12:00,Winnings,Bonus,10.0,264.58
Fanduel,2021-09-13 14:40:00,Wager,,-10.0,254.58
Fanduel,2021-09-13 22:53:00,Winnings,,19.26,273.84
Fanduel,2021-09-15 17:51:00,Wager,,-5.0,268.84
Fanduel,2021-09-15 22:51:00,Winnings,,12.5,281.34
Fanduel,2021-09-17 13:33:00,Wager,,-1.0,280.34
Fanduel,2021-09-19 11:17:00,Wager,,-10.0,270.34
Fanduel,2021-09-19 11:20:00,Wager,,-10.0,260.34
Fanduel,2021-09-19 14:45:00,Winnings,,19.52,279.86
Fanduel,2021-09-19 15:57:00,Winnings,Bonus,10.0,289.86
Fanduel,2021-09-20 12:07:00,Winnings,Bonus,5.0,294.86
Fanduel,2021-09-21 12:11:00,Wager,,-0.86,294.0
Fanduel,2021-09-23 09:06:00,Wager,,-10.0,284.0
Fanduel,2021-09-23 17:43:00,Winnings,,19.8,303.8
Fanduel,2021-09-24 10:12:00,Wager,,-5.0,298.8
Fanduel,2021-09-24 10:13:00,Wager,,-3.0,295.8
Fanduel,2021-09-24 17:00:00,Winnings,,8.42,304.22
Fanduel,2021-09-24 17:57:00,Winnings,,3.0,307.22
Fanduel,2021-09-24 17:58:00,Wager,,-5.0,302.22
Fanduel,2021-09-24 18:10:00,Wager,,-5.0,297.22
Fanduel,2021-09-24 18:11:00,Wager,,-5.0,292.22
Fanduel,2021-09-24 22:47:00,Winnings,,9.55,301.77
Fanduel,2021-09-25 12:59:00,Wager,,-10.0,291.77
Fanduel,2021-09-25 17:04:00,Winnings,,9.46,301.23
Fanduel,2021-09-25 17:40:00,Winnings,,19.52,320.75
Fanduel,2021-09-25 19:29:00,Wager,,-10.0,310.75
Fanduel,2021-09-25 19:36:00,Wager,,-20.0,290.75
Fanduel,2021-09-26 09:44:00,Winnings,,20.0,310.75
Fanduel,2021-09-26 09:48:00,Wager,,-20.0,290.75
Fanduel,2021-09-26 10:59:00,Wager,,-7.0,283.75
Fanduel,2021-09-26 16:08:00,Winnings,Bonus,10.0,293.75
Fanduel,2021-09-26 16:09:00,Winnings,Bonus,10.0,303.75
Fanduel,2021-09-26 17:56:00,Winnings,,13.67,317.42
Fanduel,2021-09-27 08:53:00,Wager,,-10.0,307.42
Fanduel,2021-09-27 11:13:00,Winnings,Bonus,5.0,312.42
Fanduel,2021-09-27 23:27:00,Winnings,,18.47,330.89
Fanduel,2021-09-28 00:05:00,Wager,,-7.0,323.89
Fanduel,2021-09-28 09:30:00,Wager,,-3.0,320.89
Fanduel,2021-09-28 21:39:00,Winnings,,5.31,326.2
Fanduel,2021-09-28 22:42:00,Winnings,,14.28,340.48
Fanduel,2021-09-29 11:57:00,Wager,,-9.0,331.48
Fanduel,2021-09-29 21:40:00,Wager,,-0.48,331.0
Fanduel,2021-10-02 23:02:00,Wager,,-10.0,321.0
Fanduel,2021-10-03 00:24:00,Wager,,-1.5,319.5
Fanduel,2021-10-03 16:35:00,Winnings,,52.17,371.67
Fanduel,2021-10-04 13:32:00,Winnings,Bonus,5.0,376.67
Fanduel,2021-10-05 12:59:00,Wager,,-20.0,356.67
Fanduel,2021-10-05 23:26:00,Winnings,,53.39,410.06
Fanduel,2021-10-05 23:27:00,Winnings,Bonus,10.0,420.06
Fanduel,2021-10-05 23:38:00,Wager,,-1.16,418.9
Fanduel,2021-10-08 12:09:00,Wager,,-20.0,398.9
Fanduel,2021-10-09 11:32:00,Wager,,-10.0,388.9
Fanduel,2021-10-09 11:33:00,Wager,,-7.5,381.4
Fanduel,2021-10-10 16:25:00,Winnings,,7.5,388.9
Fanduel,2021-10-10 19:21:00,Winnings,Bonus,10.0,398.9
Fanduel,2021-10-10 19:45:00,Wager,,-20.0,378.9
Fanduel,2021-10-10 19:46:00,Winnings,,20.0,398.9
Fanduel,2021-10-10 19:47:00,Wager,,-20.0,378.9
Fanduel,2021-10-11 00:37:00,Winnings,,105.98,484.88
Fanduel,2021-10-11 00:38:00,Winnings,Bonus,10.0,494.88
Fanduel,2021-10-11 11:20:00,Winnings,Bonus,5.0,499.88
Fanduel,2021-10-11 13:27:00,Wager,,-0.88,499.0
Fanduel,2021-10-11 23:33:00,Winnings,,2.9,501.9
Fanduel,2021-10-12 13:41:00,Wager,,-0.9,501.0
Fanduel,2021-10-14 09:28:00,Wager,,-20.0,481.0
Fanduel,2021-10-14 16:52:00,Wager,,-1.0,480.0
Fanduel,2021-10-17 01:28:00,Wager,,-10.0,470.0
Fanduel,2021-10-17 01:29:00,Wager,,-5.0,465.0
Fanduel,2021-10-17 01:31:00,Wager,,-5.0,460.0
Fanduel,2021-10-17 10:19:00,Wager,,-10.0,450.0
Fanduel,2021-10-17 16:06:00,Winnings,,11.54,461.54
Fanduel,2021-10-17 16:15:00,Winnings,Bonus,10.0,471.54
Fanduel,2021-10-17 18:21:00,Winnings,,0.35,471.89
Fanduel,2021-10-17 18:55:00,Wager,,-10.0,461.89
Fanduel,2021-10-18 23:24:00,Winnings,Bonus,10.0,471.89
Fanduel,2021-10-19 19:48:00,Wager,,-10.0,461.89
Fanduel,2021-10-20 21:36:00,Winnings,Bonus,10.0,471.89
Fanduel,2021-10-21 18:35:00,Wager,,-1.89,470.0
Fanduel,2021-10-22 19:01:00,Wager,,-4.0,466.0
Fanduel,2021-10-22 19:03:00,Wager,,-1.0,465.0
Fanduel,2021-10-22 22:19:00,Winnings,,3.55,468.55
Fanduel,2021-10-23 10:35:00,Wager,,-8.55,460.0
Fanduel,2021-10-23 20:12:00,Wager,,-20.0,440.0
Fanduel,2021-10-23 21:39:00,Wager,,-10.0,430.0
Fanduel,2021-10-24 16:02:00,Wager,,-5.0,425.0
Fanduel,2021-10-24 16:18:00,Winnings,Bonus,10.0,435.0
Fanduel,2021-10-24 23:25:00,Wager,,-39.5,395.5
Fanduel,2021-10-24 23:27:00,Wager,,-52.28,343.22
Fanduel,2021-10-25 23:19:00,Winnings,,137.06,480.28
Fanduel,2021-10-25 23:21:00,Winnings,Bonus,10.0,490.28
Fanduel,2021-10-26 12:54:00,Wager,,-10.0,480.28
Fanduel,2021-10-26 13:05:00,Wager,,-10.0,470.28
Fanduel,2021-10-26 15:19:00,Wager,,-10.01,460.27
Fanduel,2021-10-26 15:23:00,Wager,,-3.0,455.0
Fanduel,2021-10-26 15:23:00,Wager,,-2.27,458.0
Fanduel,2021-10-27 00:10:00,Wager,,-4.73,450.27
Fanduel,2021-10-27 00:22:00,Winnings,Bonus,10.0,460.27
Fanduel,2021-10-27 00:33:00,Winnings,,8.61,468.88
Fanduel,2021-10-28 15:07:00,Winnings,Bonus,10.0,478.88
Fanduel,2021-10-29 15:46:00,Wager,,-10.0,468.88
Fanduel,2021-10-29 15:54:00,Wager,,-25.0,443.88
Fanduel,2021-10-29 19:43:00,Wager,,-5.0,438.88
Fanduel,2021-10-29 23:26:00,Winnings,Bonus,10.0,448.88
Fanduel,2021-10-30 15:45:00,Wager,,-20.0,428.88
Fanduel,2021-10-30 15:47:00,Wager,,-5.0,423.88
Fanduel,2021-10-30 15:48:00,Wager,,-10.0,413.88
Fanduel,2021-10-30 15:50:00,Wager,,-5.0,408.88
Fanduel,2021-10-30 19:55:00,Winnings,Bonus,25.0,433.88
Fanduel,2021-10-31 13:48:00,Wager,,-7.0,426.88
Fanduel,2021-10-31 15:34:00,Wager,,-5.0,421.88
Fanduel,2021-10-31 16:14:00,Winnings,,11.11,432.99
Fanduel,2021-10-31 16:19:00,Winnings,,16.66,480.67
Fanduel,2021-10-31 16:19:00,Winnings,Bonus,10.0,452.71
Fanduel,2021-10-31 16:19:00,Winnings,,11.3,464.01
Fanduel,2021-10-31 16:19:00,Winnings,,9.72,473.73
Fanduel,2021-10-31 16:21:00,Wager,,-10.0,470.67
Fanduel,2021-10-31 16:36:00,Winnings,,11.5,482.17
Fanduel,2021-10-31 16:56:00,Wager,,-3.0,479.17
Fanduel,2021-10-31 19:35:00,Wager,,-1.0,478.17
Fanduel,2021-10-31 19:36:00,Winnings,Bonus,10.0,488.17
Fanduel,2021-10-31 19:40:00,Winnings,,5.73,493.9
Fanduel,2021-11-01 14:19:00,Winnings,Bonus,5.0,498.9
Fanduel,2021-11-02 15:26:00,Wager,,-10.0,488.9
Fanduel,2021-11-02 21:05:00,Wager,,-20.0,468.9
Fanduel,2021-11-02 21:54:00,Winnings,Bonus,10.0,478.9
Fanduel,2021-11-02 21:55:00,Winnings,,23.85,502.75
Fanduel,2021-11-03 19:09:00,Wager,,-2.75,500.0
Fanduel,2021-11-04 20:12:00,Wager,,-6.5,493.5
Fanduel,2021-11-07 10:28:00,Wager,,-20.0,473.5
Fanduel,2021-11-07 15:44:00,Wager,,-10.0,463.5
Fanduel,2021-11-07 15:47:00,Wager,,-9.75,453.75
Fanduel,2021-11-07 15:51:00,Wager,,-10.0,433.75
Fanduel,2021-11-07 15:51:00,Wager,,-10.0,443.75
Fanduel,2021-11-07 16:05:00,Winnings,,16.16,449.91
Fanduel,2021-11-07 16:06:00,Winnings,Bonus,10.0,459.91
Fanduel,2021-11-07 16:12:00,Winnings,,18.2,478.11
Fanduel,2021-11-07 16:12:00,Winnings,,14.88,492.99
Fanduel,2021-11-07 16:12:00,Winnings,,14.65,507.64
Fanduel,2021-11-07 16:22:00,Wager,,-10.0,497.64
Fanduel,2021-11-07 17:34:00,Wager,,-10.0,487.64
Fanduel,2021-11-07 19:33:00,Winnings,Bonus,10.0,497.64
Fanduel,2021-11-07 19:37:00,Winnings,,18.7,516.34
Fanduel,2021-11-08 22:57:00,Wager,,-5.0,511.34
Fanduel,2021-11-09 18:47:00,Wager,,-10.0,501.34
Fanduel,2021-11-09 22:30:00,Winnings,Bonus,10.0,511.34
Fanduel,2021-11-09 23:05:00,Wager,,-10.0,501.34
Fanduel,2021-11-11 22:01:00,Wager,,-5.0,496.34
Fanduel,2021-11-12 22:19:00,Wager,,-0.34,496.0
Fanduel,2021-11-12 22:51:00,Winnings,,2.89,498.89
Fanduel,2021-11-13 12:37:00,Wager,,-20.0,478.89
Fanduel,2021-11-13 17:25:00,Wager,,-5.0,473.89
Fanduel,2021-11-13 19:04:00,Winnings,,9.63,483.52
Fanduel,2021-11-14 15:32:00,Wager,,-35.0,448.52
Fanduel,2021-11-14 15:50:00,Wager,,-100.0,348.52
Fanduel,2021-11-14 16:02:00,Winnings,,64.66,413.18
Fanduel,2021-11-14 16:02:00,Winnings,,102.22,515.4
Fanduel,2021-11-14 16:06:00,Winnings,Bonus,10.0,525.4
Fanduel,2021-11-14 16:18:00,Wager,,-10.0,515.4
Fanduel,2021-11-14 19:26:00,Winnings,Bonus,10.0,525.4
Fanduel,2021-11-15 13:44:00,Winnings,Bonus,5.0,530.4
Fanduel,2021-11-16 19:56:00,Wager,,-10.0,520.4
Fanduel,2021-11-17 00:17:00,Winnings,Bonus,10.0,530.4
Fanduel,2021-11-21 10:53:00,Wager,,-20.0,510.4
Fanduel,2021-11-21 11:37:00,Wager,,-10.0,500.4
Fanduel,2021-11-21 15:03:00,Wager,,-25.0,475.4
Fanduel,2021-11-21 16:02:00,Winnings,,36.36,511.76
Fanduel,2021-11-21 16:04:00,Winnings,Bonus,10.0,521.76
Fanduel,2021-11-21 16:18:00,Wager,,-10.0,511.76
Fanduel,2021-11-21 19:28:00,Winnings,Bonus,10.0,521.76
Fanduel,2021-11-24 00:32:00,Wager,,-10.0,511.76
Fanduel,2021-11-24 00:34:00,Wager,,-10.0,501.76
Fanduel,2021-11-24 21:07:00,Wager,,-5.0,496.76
Fanduel,2021-11-25 11:23:00,Wager,,-3.0,493.76
Fanduel,2021-11-25 14:13:00,Wager,,-7.0,486.76
Fanduel,2021-11-25 15:41:00,Winnings,,13.6,500.36
Fanduel,2021-11-25 18:20:00,Wager,,-15.0,485.36
Fanduel,2021-11-25 23:14:00,Winnings,,30.0,515.36
Fanduel,2021-11-26 11:30:00,Winnings,Bonus,5.0,520.36
Fanduel,2021-11-27 11:21:00,Wager,,-5.0,515.36
Fanduel,2021-11-27 11:29:00,Winnings,,5.0,520.36
Fanduel,2021-11-27 11:29:00,Wager,,-5.0,515.36
Fanduel,2021-11-28 19:55:00,Wager,,-5.0,510.36
Fanduel,2021-11-28 22:43:00,Wager,,-15.0,495.36
Fanduel,2021-11-30 08:57:00,Wager,,-10.0,485.36
Fanduel,2021-11-30 10:23:00,Winnings,,10.0,495.36
Fanduel,2021-11-30 13:12:00,Winnings,Bonus,10.0,505.36
Fanduel,2021-11-30 18:19:00,Wager,,-10.0,495.36
Fanduel,2021-11-30 22:04:00,Wager,,-10.0,485.36
Fanduel,2021-11-30 22:04:00,Wager,,-5.0,480.36
Fanduel,2021-12-01 00:23:00,Winnings,Bonus,10.0,490.36
Fanduel,2021-12-02 20:02:00,Wager,,-10.0,480.36
Fanduel,2021-12-02 20:02:00,Wager,,-25.0,455.36
Fanduel,2021-12-02 23:36:00,Winnings,,70.0,525.36
Fanduel,2021-12-03 15:48:00,Wager,,-10.0,515.36
Fanduel,2021-12-03 23:32:00,Winnings,,19.09,534.45
Fanduel,2021-12-05 02:37:00,Wager,,-20.0,514.45
Fanduel,2021-12-05 02:42:00,Wager,,-15.0,499.45
Fanduel,2021-12-05 10:07:00,Wager,,-5.0,494.45
Fanduel,2021-12-05 13:31:00,Wager,,-10.0,484.45
Fanduel,2021-12-05 16:08:00,Winnings,,22.0,506.45
Fanduel,2021-12-05 18:51:00,Wager,,-8.0,498.45
Fanduel,2021-12-05 19:07:00,Winnings,,17.6,516.05
Fanduel,2021-12-05 19:07:00,Winnings,Bonus,10.0,526.05
Fanduel,2021-12-05 20:18:00,Wager,,-5.0,521.05
Fanduel,2021-12-06 18:55:00,Wager,,-10.0,511.05
Fanduel,2021-12-06 18:56:00,Wager,,-5.0,506.05
Fanduel,2021-12-06 19:07:00,Wager,,-5.0,501.05
Fanduel,2021-12-06 23:10:00,Winnings,Bonus,10.0,511.05
Fanduel,2021-12-06 23:16:00,Winnings,,9.55,520.6
Fanduel,2021-12-06 23:21:00,Winnings,,16.0,536.6
Fanduel,2021-12-07 18:42:00,Wager,,-10.0,526.6
Fanduel,2021-12-07 18:49:00,Wager,,-3.0,523.6
Fanduel,2021-12-07 23:00:00,Wager,,-2.0,521.6
Fanduel,2021-12-08 00:29:00,Winnings,Bonus,10.0,531.6
Fanduel,2021-12-09 08:54:00,Wager,,-15.0,516.6
Fanduel,2021-12-09 08:56:00,Wager,,-2.0,514.6
Fanduel,2021-12-10 22:07:00,Wager,,-1.0,513.6
Fanduel,2021-12-10 22:19:00,Winnings,,7.5,521.1
Fanduel,2021-12-11 19:42:00,Wager,,-10.0,511.1
Fanduel,2021-12-11 19:48:00,Wager,,-10.0,501.1
Fanduel,2021-12-11 20:01:00,Wager,,-5.0,496.1
Fanduel,2021-12-12 01:02:00,Wager,,-5.0,491.1
Fanduel,2021-12-12 01:05:00,Wager,,-5.0,486.1
Fanduel,2021-12-12 15:18:00,Wager,,-2.0,484.1
Fanduel,2021-12-12 16:35:00,Winnings,,2.87,486.97
Fanduel,2021-12-12 21:57:00,Winnings,,20.0,506.97
Fanduel,2021-12-12 22:07:00,Wager,,-5.0,501.97
Fanduel,2021-12-13 13:16:00,Wager,,-5.0,496.97
Fanduel,2021-12-13 23:18:00,Winnings,Bonus,10.0,506.97
Fanduel,2021-12-14 14:50:00,Wager,,-3.0,503.97
Fanduel,2021-12-14 14:56:00,Wager,,-10.0,493.97
Fanduel,2021-12-14 14:58:00,Wager,,-3.0,490.97
Fanduel,2021-12-14 19:42:00,Winnings,,7.5,498.47
Fanduel,2021-12-14 21:58:00,Winnings,Bonus,10.0,508.47
Fanduel,2021-12-15 20:57:00,Wager,,-5.0,503.47
Fanduel,2021-12-15 22:12:00,Winnings,,7.27,510.74
Fanduel,2021-12-16 11:24:00,Wager,,-3.0,507.74
Fanduel,2021-12-16 19:55:00,Wager,,-1.0,506.74
Fanduel,2021-12-16 20:19:00,Wager,,-0.5,506.24
Fanduel,2021-12-17 22:10:00,Wager,,-20.0,486.24
Fanduel,2021-12-17 22:12:00,Winnings,,20.0,506.24
Fanduel,2021-12-17 22:16:00,Wager,,-20.0,486.24
Fanduel,2021-12-19 00:04:00,Wager,,-4.5,481.74
Fanduel,2021-12-19 10:18:00,Wager,,-5.0,476.74
Fanduel,2021-12-19 10:26:00,Wager,,-5.0,471.74
Fanduel,2021-12-19 13:10:00,Wager,,-5.0,466.74
Fanduel,2021-12-20 11:59:00,Winnings,Bonus,5.0,471.74
Fanduel,2021-12-20 12:39:00,Wager,,-8.0,458.74
Fanduel,2021-12-20 12:39:00,Wager,,-5.0,466.74
Fanduel,2021-12-20 15:51:00,Wager,,-5.0,453.74
Fanduel,2021-12-20 20:04:00,Winnings,,113.84,567.58
Fanduel,2021-12-20 20:04:00,Winnings,Bonus,10.0,577.58
Fanduel,2021-12-20 23:15:00,Wager,,-1.0,576.58
Fanduel,2021-12-20 23:24:00,Winnings,,5.8,582.38
Fanduel,2021-12-21 16:16:00,Wager,,-5.0,577.38
Fanduel,2021-12-21 16:21:00,Wager,,-5.0,572.38
Fanduel,2021-12-21 16:22:00,Wager,,-4.0,568.38
Fanduel,2021-12-21 16:22:00,Wager,,-1.0,567.38
Fanduel,2021-12-21 16:31:00,Wager,,-10.0,557.38
Fanduel,2021-12-21 20:22:00,Wager,,-3.0,554.38
Fanduel,2021-12-21 21:47:00,Winnings,Bonus,10.0,564.38
Fanduel,2021-12-21 21:58:00,Winnings,Bonus,10.0,574.38
Fanduel,2021-12-21 22:12:00,Winnings,,5.61,579.99
Fanduel,2021-12-22 11:06:00,Wager,,-10.0,569.99
Fanduel,2021-12-22 21:05:00,Wager,,-3.0,566.99
Fanduel,2021-12-22 21:48:00,Wager,,-7.0,559.99
Fanduel,2021-12-22 22:47:00,Wager,,-5.0,554.99
Fanduel,2021-12-22 23:08:00,Winnings,,6.36,561.35
Fanduel,2021-12-22 23:08:00,Winnings,,9.55,570.9
Fanduel,2021-12-22 23:08:00,Winnings,Bonus,10.0,580.9
Fanduel,2021-12-22 23:08:00,Winnings,,17.08,597.98
Fanduel,2021-12-23 19:37:00,Wager,,-10.0,587.98
Fanduel,2021-12-23 19:40:00,Wager,,-10.0,577.98
Fanduel,2021-12-23 19:47:00,Wager,,-5.0,572.98
Fanduel,2021-12-23 21:39:00,Wager,,-2.0,570.98
Fanduel,2021-12-23 23:14:00,Winnings,Bonus,10.0,580.98
Fanduel,2021-12-23 23:19:00,Winnings,,3.67,584.65
Fanduel,2021-12-24 11:27:00,Wager,,-5.0,579.65
Fanduel,2021-12-24 11:30:00,Wager,,-5.0,574.65
Fanduel,2021-12-24 11:32:00,Wager,,-5.0,569.65
Fanduel,2021-12-24 11:33:00,Wager,,-5.0,564.65
Fanduel,2021-12-24 12:11:00,Wager,,-10.0,554.65
Fanduel,2021-12-25 19:35:00,Winnings,,26.84,581.49
Fanduel,2021-12-26 11:23:00,Winnings,Bonus,10.0,591.49
Fanduel,2021-12-26 16:18:00,Winnings,Bonus,10.0,601.49
Fanduel,2021-12-27 11:13:00,Winnings,Bonus,5.0,606.49
Fanduel,2021-12-31 13:06:00,Wager,,-5.0,601.49
Fanduel,2021-12-31 13:20:00,Wager,,-5.0,596.49
Fanduel,2021-12-31 13:34:00,Wager,,-5.0,591.49
Fanduel,2021-12-31 13:39:00,Wager,,-5.0,586.49
Fanduel,2021-12-31 13:42:00,Wager,,-5.0,581.49
Fanduel,2021-12-31 13:44:00,Wager,,-1.0,580.49
Fanduel,2021-12-31 13:47:00,Wager,,-14.0,566.49
Fanduel,2021-12-31 13:48:00,Wager,,-1.0,565.49
Fanduel,2021-12-31 19:29:00,Wager,,-2.0,563.49
Fanduel,2021-12-31 22:12:00,Winnings,,3.7,567.19
Fanduel,2022-01-01 16:51:00,Wager,,-2.0,565.19
Fanduel,2022-01-01 21:05:00,Wager,,-8.0,557.19
Fanduel,2022-01-01 21:47:00,Wager,,-2.0,555.19
Fanduel,2022-01-02 00:26:00,Winnings,,37.5,592.69
Fanduel,2022-01-02 00:57:00,Wager,,-5.0,587.69
Fanduel,2022-01-02 01:05:00,Wager,,-5.0,582.69
Fanduel,2022-01-02 01:14:00,Wager,,-5.0,577.69
Fanduel,2022-01-02 01:21:00,Wager,,-5.0,572.69
Fanduel,2022-01-02 01:24:00,Wager,,-10.0,562.69
Fanduel,2022-01-02 12:52:00,Winnings,Bonus,10.0,572.69
Fanduel,2022-01-02 15:40:00,Wager,,-5.0,567.69
Fanduel,2022-01-02 16:10:00,Winnings,,25.26,592.95
Fanduel,2022-01-02 16:11:00,Winnings,Bonus,10.0,602.95
Fanduel,2022-01-02 16:23:00,Wager,,-2.95,600.0
Fanduel,2022-01-02 19:32:00,Winnings,,14.07,614.07
Fanduel,2022-01-02 19:47:00,Winnings,,19.09,633.16
Fanduel,2022-01-02 19:59:00,Wager,,-7.05,626.11
Fanduel,2022-01-03 11:26:00,Winnings,Bonus,5.0,631.11
Fanduel,2022-01-07 17:33:00,Wager,,-25.0,606.11
Fanduel,2022-01-08 08:57:00,Wager,,-2.0,604.11
Fanduel,2022-01-08 10:22:00,Winnings,Bonus,22.0,626.11
Fanduel,2022-01-09 09:40:00,Wager,,-5.0,621.11
Fanduel,2022-01-09 09:47:00,Wager,,-5.0,616.11
Fanduel,2022-01-09 09:52:00,Wager,,-5.0,611.11
Fanduel,2022-01-09 09:58:00,Wager,,-5.0,606.11
Fanduel,2022-01-09 10:05:00,Wager,,-25.0,581.11
Fanduel,2022-01-09 12:05:00,Wager,,-1.0,580.11
Fanduel,2022-01-09 13:53:00,Wager,,-4.0,576.11
Fanduel,2022-01-09 13:53:00,Wager,,-4.0,572.11
Fanduel,2022-01-09 16:13:00,Winnings,,14.78,586.89
Fanduel,2022-01-09 19:36:00,Winnings,Bonus,10.0,596.89
Fanduel,2022-01-09 21:04:00,Wager,,-5.0,591.89
Fanduel,2022-01-09 21:05:00,Wager,,-2.0,589.89
Fanduel,2022-01-12 17:20:00,Wager,,-3.0,586.89
Fanduel,2022-01-12 21:41:00,Winnings,,8.4,595.29
Fanduel,2022-01-13 11:58:00,Wager,,-10.0,585.29
Fanduel,2022-01-13 21:47:00,Winnings,Bonus,10.0,595.29
Fanduel,2022-01-14 17:18:00,Wager,,-25.0,570.29
Fanduel,2022-01-14 17:30:00,Wager,,-3.0,567.29
Fanduel,2022-01-15 11:28:00,Wager,,-5.0,562.29
Fanduel,2022-01-15 11:29:00,Wager,,-3.0,559.29
Fanduel,2022-01-15 11:35:00,Wager,,-10.0,549.29
Fanduel,2022-01-15 11:42:00,Wager,,-10.0,539.29
Fanduel,2022-01-15 11:49:00,Wager,,-10.0,529.29
Fanduel,2022-01-15 16:00:00,Winnings,Bonus,25.0,554.29
Fanduel,2022-01-16 12:38:00,Wager,,-10.0,544.29
Fanduel,2022-01-16 12:40:00,Wager,,-4.0,540.29
Fanduel,2022-01-16 12:41:00,Wager,,-10.0,530.29
Fanduel,2022-01-16 16:16:00,Winnings,,10.05,540.34
Fanduel,2022-01-16 17:37:00,Wager,,-5.0,535.34
Fanduel,2022-01-16 20:03:00,Winnings,,9.39,544.73
Fanduel,2022-01-16 23:17:00,Winnings,,53.23,597.96
Fanduel,2022-01-17 16:36:00,Wager,,-5.0,592.96
Fanduel,2022-01-18 15:55:00,Winnings,Bonus,25.0,617.96
Fanduel,2022-01-19 11:25:00,Wager,,-7.0,610.96
Fanduel,2022-01-19 11:28:00,Wager,,-3.0,607.96
Fanduel,2022-01-19 11:29:00,Wager,,-15.0,592.96
Fanduel,2022-01-19 22:40:00,Winnings,Bonus,7.0,599.96
Fanduel,2022-01-19 23:11:00,Winnings,,15.21,615.17
Fanduel,2022-01-19 23:14:00,Winnings,Bonus,3.0,618.17
Fanduel,2022-01-20 18:55:00,Wager,,-10.0,608.17
Fanduel,2022-01-20 18:58:00,Wager,,-3.0,605.17
Fanduel,2022-01-20 21:55:00,Winnings,Bonus,10.0,615.17
Fanduel,2022-01-21 19:59:00,Wager,,-25.0,590.17
Fanduel,2022-01-22 12:43:00,Winnings,Bonus,13.0,603.17
Fanduel,2022-01-22 14:35:00,Wager,,-4.0,599.17
Fanduel,2022-01-22 14:36:00,Wager,,-4.0,595.17
Fanduel,2022-01-22 20:03:00,Winnings,,12.8,607.97
Fanduel,2022-01-23 13:59:00,Wager,,-5.0,602.97
Fanduel,2022-01-23 14:55:00,Wager,,-10.0,592.97
Fanduel,2022-01-23 14:56:00,Wager,,-2.0,590.97
Fanduel,2022-01-23 14:56:00,Wager,,-15.0,575.97
Fanduel,2022-01-23 18:26:00,Winnings,,15.08,591.05
Fanduel,2022-01-23 21:29:00,Wager,,-5.0,586.05
Fanduel,2022-01-23 21:57:00,Winnings,,52.74,638.79
Fanduel,2022-01-23 21:57:00,Winnings,,12.0,650.79
Fanduel,2022-01-25 19:27:00,Wager,,-5.0,645.79
Fanduel,2022-01-26 11:34:00,Wager,,-5.0,640.79
Fanduel,2022-01-26 11:38:00,Wager,,-5.0,635.79
Fanduel,2022-01-26 11:43:00,Wager,,-3.0,632.79
Fanduel,2022-01-26 11:46:00,Wager,,-2.79,630.0
Fanduel,2022-01-27 19:23:00,Wager,,-10.0,620.0
Fanduel,2022-01-27 19:26:00,Wager,,-1.0,619.0
Fanduel,2022-01-28 00:34:00,Winnings,Bonus,10.0,629.0
Fanduel,2022-01-28 18:42:00,Wager,,-25.0,604.0
Fanduel,2022-01-28 20:18:00,Winnings,,120.0,724.0
Fanduel,2022-01-29 10:38:00,Winnings,Bonus,25.0,749.0
Fanduel,2022-01-29 12:02:00,Wager,,-3.0,746.0
Fanduel,2022-01-30 14:47:00,Wager,,-10.0,736.0
Fanduel,2022-01-30 21:41:00,Winnings,Bonus,10.0,746.0
Fanduel,2022-01-31 20:13:00,Wager,,-6.0,740.0
Fanduel,2022-01-31 20:15:00,Wager,,-10.0,730.0
Fanduel,2022-01-31 20:20:00,Wager,,-5.0,725.0
Fanduel,2022-01-31 20:52:00,Winnings,,10.01,735.01
Fanduel,2022-01-31 21:51:00,Winnings,,5.13,740.14
Fanduel,2022-02-01 17:58:00,Wager,,-4.0,736.14
Fanduel,2022-02-01 18:01:00,Wager,,-4.0,732.14
Fanduel,2022-02-01 18:08:00,Wager,,-4.0,728.14
Fanduel,2022-02-01 18:16:00,Wager,,-2.0,726.14
Fanduel,2022-02-01 18:17:00,Wager,,-3.0,723.14
Fanduel,2022-02-01 21:35:00,Winnings,,12.85,735.99
Fanduel,2022-02-01 22:33:00,Winnings,Bonus,4.0,739.99
Fanduel,2022-02-01 22:51:00,Winnings,,21.97,761.96
Fanduel,2022-02-01 23:28:00,Winnings,,22.61,784.57
Fanduel,2022-02-01 23:33:00,Winnings,,10.5,795.07
Fanduel,2022-02-02 18:01:00,Wager,,-5.0,790.07
Fanduel,2022-02-02 18:05:00,Wager,,-4.0,786.07
Fanduel,2022-02-02 18:09:00,Wager,,-4.0,782.07
Fanduel,2022-02-02 18:13:00,Wager,,-4.0,778.07
Fanduel,2022-02-02 18:19:00,Wager,,-4.0,774.07
Fanduel,2022-02-02 18:25:00,Wager,,-4.0,770.07
Fanduel,2022-02-02 21:20:00,Winnings,,26.38,796.45
Fanduel,2022-02-02 21:33:00,Winnings,,12.0,808.45
Fanduel,2022-02-02 21:50:00,Winnings,Bonus,4.0,812.45
Fanduel,2022-02-02 22:44:00,Wager,,-5.0,807.45
Fanduel,2022-02-02 23:10:00,Winnings,Bonus,4.0,811.45
Fanduel,2022-02-03 00:13:00,Winnings,,6.0,817.45
Fanduel,2022-02-03 15:52:00,Wager,,-10.0,807.45
Fanduel,2022-02-03 15:53:00,Wager,,-8.0,799.45
Fanduel,2022-02-03 18:54:00,Wager,,-20.0,779.45
Fanduel,2022-02-03 21:55:00,Winnings,Bonus,10.0,789.45
Fanduel,2022-02-03 22:05:00,Winnings,Bonus,20.0,809.45
Fanduel,2022-02-03 22:51:00,Winnings,,8.1,817.55
Fanduel,2022-02-04 12:03:00,Wager,,-10.0,807.55
Fanduel,2022-02-04 16:53:00,Winnings,,50.44,857.99
Fanduel,2022-02-05 09:57:00,Wager,,-10.0,847.99
Fanduel,2022-02-05 10:00:00,Wager,,-16.0,831.99
Fanduel,2022-02-05 10:00:00,Wager,,-3.0,828.99
Fanduel,2022-02-05 10:00:00,Winnings,,3.0,831.99
Fanduel,2022-02-05 10:02:00,Wager,,-3.0,828.99
Fanduel,2022-02-05 10:03:00,Wager,,-2.0,826.99
Fanduel,2022-02-05 10:04:00,Winnings,,2.0,828.99
Fanduel,2022-02-05 10:04:00,Winnings,,16.0,844.99
Fanduel,2022-02-05 10:06:00,Wager,,-12.0,832.99
Fanduel,2022-02-05 12:08:00,Winnings,,3.0,835.99
Fanduel,2022-02-05 12:10:00,Winnings,,12.0,847.99
Fanduel,2022-02-05 12:11:00,Wager,,-8.49,839.5
Fanduel,2022-02-05 17:08:00,Winnings,,21.23,860.73
Fanduel,2022-02-05 23:38:00,Winnings,Bonus,10.0,870.73
Fanduel,2022-02-06 17:19:00,Wager,,-2.51,868.22
Fanduel,2022-02-06 17:49:00,Winnings,,2.52,870.74
Fanduel,2022-02-06 20:42:00,Wager,,-4.0,866.74
Fanduel,2022-02-06 23:58:00,Winnings,,10.4,877.14
Fanduel,2022-02-07 19:16:00,Wager,,-5.0,872.14
Fanduel,2022-02-08 16:29:00,Wager,,-7.0,865.14
Fanduel,2022-02-08 17:50:00,Wager,,-4.0,861.14
Fanduel,2022-02-08 17:53:00,Wager,,-4.0,857.14
Fanduel,2022-02-08 17:56:00,Wager,,-4.0,853.14
Fanduel,2022-02-08 18:00:00,Wager,,-4.0,849.14
Fanduel,2022-02-08 18:02:00,Wager,,-2.0,847.14
Fanduel,2022-02-08 19:07:00,Wager,,-2.0,845.14
Fanduel,2022-02-08 19:07:00,Wager,,-1.0,844.14
Fanduel,2022-02-08 23:16:00,Winnings,Bonus,4.0,848.14
Fanduel,2022-02-09 00:50:00,Winnings,Bonus,4.0,852.14
Fanduel,2022-02-09 17:48:00,Wager,,-4.0,848.14
Fanduel,2022-02-09 17:50:00,Wager,,-4.0,844.14
Fanduel,2022-02-09 17:51:00,Wager,,-4.0,840.14
Fanduel,2022-02-09 17:53:00,Wager,,-4.0,836.14
Fanduel,2022-02-09 22:14:00,Winnings,Bonus,4.0,840.14
Fanduel,2022-02-10 16:20:00,Wager,,-10.0,830.14
Fanduel,2022-02-11 00:39:00,Winnings,Bonus,10.0,840.14
Fanduel,2022-02-12 18:07:00,Wager,,-10.0,830.14
Fanduel,2022-02-12 23:18:00,Winnings,Bonus,10.0,840.14
Fanduel,2022-02-13 12:15:00,Wager,,-12.0,828.14
Fanduel,2022-02-13 15:00:00,Winnings,,12.57,840.71
Fanduel,2022-02-13 16:03:00,Wager,,-20.0,820.71
Fanduel,2022-02-13 22:06:00,Winnings,,35.0,855.71
Fanduel,2022-02-13 22:23:00,Winnings,Bonus,20.0,875.71
Fanduel,2022-02-15 12:00:00,Wager,,-10.0,865.71
Fanduel,2022-02-15 12:22:00,Wager,,-10.0,855.71
Fanduel,2022-02-15 16:18:00,Winnings,Bonus,10.0,865.71
Fanduel,2022-02-16 17:00:00,Winnings,,15.0,865.71
Fanduel,2022-02-16 17:00:00,Wager,,-15.0,850.71
Fanduel,2022-02-16 17:00:00,Wager,,-5.0,860.71
Fanduel,2022-02-16 17:00:00,Winnings,,5.0,865.71
Fanduel,2022-02-17 19:06:00,Wager,,-10.0,855.71
Fanduel,2022-02-17 19:07:00,Wager,,-10.0,845.71
Fanduel,2022-02-17 19:07:00,Winnings,,10.0,855.71
Fanduel,2022-02-17 23:10:00,Winnings,Bonus,10.0,865.71
Fanduel,2022-02-19 19:07:00,Wager,,-5.0,860.71
Fanduel,2022-02-19 19:08:00,Wager,,-5.0,860.71
Fanduel,2022-02-19 19:08:00,Winnings,,5.0,865.71
Fanduel,2022-02-19 19:10:00,Wager,,-4.0,856.71
Fanduel,2022-02-22 10:02:00,Wager,,-5.0,851.71
Fanduel,2022-02-22 10:03:00,Wager,,-5.0,846.71
Fanduel,2022-02-22 10:03:00,Winnings,,5.0,851.71
Fanduel,2022-02-23 09:30:00,Wager,,-3.0,848.71
Fanduel,2022-02-23 09:31:00,Wager,,-3.0,845.71
Fanduel,2022-02-23 20:50:00,Winnings,,3.3,849.01
Fanduel,2022-02-24 16:18:00,Wager,,-3.0,846.01
Fanduel,2022-02-24 16:19:00,Wager,,-3.0,843.01
Fanduel,2022-02-24 20:04:00,Wager,,-1.0,842.01
Fanduel,2022-02-24 20:22:00,Winnings,,7.5,849.51
Fanduel,2022-02-24 22:06:00,Winnings,,10.5,860.01
Fanduel,2022-02-25 16:17:00,Winnings,Bonus,5.0,865.01
Fanduel,2022-02-25 16:55:00,Wager,,-2.0,863.01
Fanduel,2022-02-25 23:22:00,Winnings,,7.0,870.01
Fanduel,2022-02-28 17:24:00,Wager,,-10.0,860.01
Fanduel,2022-02-28 23:22:00,Winnings,,18.7,878.71
Fanduel,2022-03-01 18:58:00,Wager,,-18.7,860.01
Fanduel,2022-03-01 22:05:00,Wager,,-0.1,859.91
Fanduel,2022-03-01 22:07:00,Wager,,-0.1,859.81
Fanduel,2022-03-01 22:26:00,Wager,,-0.81,859.0
Fanduel,2022-03-01 22:46:00,Winnings,,35.1,894.1
Fanduel,2022-03-02 17:48:00,Wager,,-35.1,859.0
Fanduel,2022-03-03 18:06:00,Wager,,-25.0,834.0
Fanduel,2022-03-04 12:08:00,Winnings,Bonus,25.0,859.0
Fanduel,2022-03-04 17:26:00,Winnings,Bonus,-5.0,854.0
Fanduel,2022-03-05 10:44:00,Wager,,-25.0,829.0
Fanduel,2022-03-05 10:48:00,Wager,,-5.0,824.0
Fanduel,2022-03-05 10:48:00,Wager,,-4.0,820.0
Fanduel,2022-03-05 10:51:00,Wager,,-4.0,816.0
Fanduel,2022-03-05 18:36:00,Wager,,-3.0,813.0
Fanduel,2022-03-05 23:09:00,Winnings,,7.5,820.5
Fanduel,2022-03-06 00:15:00,Winnings,,26.38,846.88
Fanduel,2022-03-06 01:07:00,Winnings,Bonus,4.0,850.88
Fanduel,2022-03-06 12:24:00,Winnings,Bonus,16.0,866.88
Fanduel,2022-03-06 14:05:00,Wager,,-10.0,856.88
Fanduel,2022-03-06 18:07:00,Winnings,Bonus,10.0,866.88
Fanduel,2022-03-07 09:09:00,Winnings,,7.0,866.88
Fanduel,2022-03-07 09:09:00,Wager,,-10.0,856.88
Fanduel,2022-03-07 09:09:00,Wager,,-7.0,859.88
Fanduel,2022-03-07 09:10:00,Winnings,,10.0,866.88
Fanduel,2022-03-07 18:45:00,Wager,,-10.0,856.88
Fanduel,2022-03-08 11:27:00,Wager,,-10.0,846.88
Fanduel,2022-03-08 16:58:00,Winnings,Bonus,10.0,856.88
Fanduel,2022-03-09 23:43:00,Wager,,-0.88,856.0
Fanduel,2022-03-10 00:26:00,Winnings,,1.6,857.6
Fanduel,2022-03-10 09:07:00,Wager,,-8.0,849.6
Fanduel,2022-03-10 18:30:00,Wager,,-10.0,839.6
Fanduel,2022-03-10 22:08:00,Winnings,Bonus,10.0,849.6
Fanduel,2022-03-11 16:29:00,Wager,,-6.0,843.6
Fanduel,2022-03-11 16:32:00,Wager,,-5.0,838.6
Fanduel,2022-03-12 15:18:00,Wager,,-5.0,833.6
Fanduel,2022-03-12 15:20:00,Wager,,-4.0,829.6
Fanduel,2022-03-12 15:22:00,Wager,,-5.0,824.6
Fanduel,2022-03-12 15:24:00,Wager,,-3.0,821.6
Fanduel,2022-03-12 17:49:00,Winnings,Bonus,10.0,831.6
Fanduel,2022-03-12 19:51:00,Winnings,,27.48,859.08
Fanduel,2022-03-13 00:32:00,Wager,,-10.0,849.08
Fanduel,2022-03-13 00:32:00,Winnings,,10.0,859.08
Fanduel,2022-03-13 00:33:00,Wager,,-10.0,849.08
Fanduel,2022-03-13 00:33:00,Wager,,-8.0,851.08
Fanduel,2022-03-13 00:33:00,Winnings,,10.0,859.08
Fanduel,2022-03-13 00:33:00,Winnings,,8.0,859.08
Fanduel,2022-03-13 00:34:00,Wager,,-10.0,849.08
Fanduel,2022-03-13 00:34:00,Winnings,,10.0,859.08
Fanduel,2022-03-13 12:57:00,Wager,,-10.0,849.08
Fanduel,2022-03-13 18:02:00,Winnings,Bonus,10.0,859.08
Fanduel,2022-03-17 19:13:00,Wager,,-4.0,855.08
Fanduel,2022-03-17 19:21:00,Wager,,-7.0,848.08
Fanduel,2022-03-17 19:24:00,Wager,,-3.0,845.08
Fanduel,2022-03-17 19:27:00,Wager,,-5.0,840.08
Fanduel,2022-03-17 19:29:00,Wager,,-4.0,836.08
Fanduel,2022-03-17 22:32:00,Winnings,,36.55,872.63
Fanduel,2022-03-18 00:45:00,Winnings,Bonus,3.0,875.63
Fanduel,2022-03-18 00:50:00,Winnings,,25.16,900.79
Fanduel,2022-03-18 12:43:00,Wager,,-6.0,894.79
Fanduel,2022-03-18 12:46:00,Wager,,-6.0,888.79
Fanduel,2022-03-18 12:48:00,Wager,,-1.0,887.79
Fanduel,2022-03-18 12:50:00,Wager,,-6.0,881.79
Fanduel,2022-03-18 15:01:00,Wager,,-17.12,864.67
Fanduel,2022-03-18 16:06:00,Winnings,,17.14,881.81
Fanduel,2022-03-18 17:23:00,Wager,,-5.0,876.81
Fanduel,2022-03-18 17:31:00,Wager,,-6.0,870.81
Fanduel,2022-03-18 17:45:00,Wager,,-3.81,867.0
Fanduel,2022-03-18 18:29:00,Winnings,,31.4,898.4
Fanduel,2022-03-18 21:28:00,Winnings,Bonus,6.0,904.4
Fanduel,2022-03-18 21:42:00,Wager,,-6.0,898.4
Fanduel,2022-03-18 22:09:00,Winnings,,9.53,907.93
Fanduel,2022-03-19 00:47:00,Winnings,Bonus,6.0,913.93
Fanduel,2022-03-19 08:12:00,Wager,,-8.0,905.93
Fanduel,2022-03-19 08:14:00,Wager,,-8.0,897.93
Fanduel,2022-03-19 08:21:00,Wager,,-8.0,889.93
Fanduel,2022-03-19 12:38:00,Wager,,-6.0,883.93
Fanduel,2022-03-19 12:57:00,Winnings,,6.43,890.36
Fanduel,2022-03-19 19:56:00,Winnings,Bonus,8.0,898.36
Fanduel,2022-03-19 22:53:00,Winnings,,42.08,940.44
Fanduel,2022-03-19 22:57:00,Wager,,-4.0,936.44
Fanduel,2022-03-20 11:53:00,Wager,,-8.0,928.44
Fanduel,2022-03-20 11:56:00,Wager,,-8.0,920.44
Fanduel,2022-03-20 12:00:00,Wager,,-8.0,912.44
Fanduel,2022-03-20 13:27:00,Wager,,-8.0,904.44
Fanduel,2022-03-20 13:28:00,Wager,,-1.0,903.44
Fanduel,2022-03-20 23:32:00,Winnings,,41.82,945.26
Fanduel,2022-03-20 23:37:00,Winnings,Bonus,8.0,953.26
Fanduel,2022-03-21 00:01:00,Winnings,Bonus,8.0,961.26
Fanduel,2022-03-21 00:42:00,Winnings,,51.85,1013.11
Fanduel,2022-03-23 10:54:00,Wager,,-7.0,1003.11
Fanduel,2022-03-23 10:54:00,Winnings,,7.0,1010.11
Fanduel,2022-03-23 10:54:00,Wager,,-3.0,1010.11
Fanduel,2022-03-24 19:00:00,Wager,,-8.0,1002.11
Fanduel,2022-03-24 19:05:00,Wager,,-8.0,994.11
Fanduel,2022-03-24 19:09:00,Wager,,-8.0,986.11
Fanduel,2022-03-24 19:16:00,Wager,,-8.0,978.11
Fanduel,2022-03-24 19:20:00,Wager,,-6.0,972.11
Fanduel,2022-03-24 22:20:00,Winnings,,40.13,1012.24
Fanduel,2022-03-24 22:51:00,Winnings,Bonus,8.0,1020.24
Fanduel,2022-03-25 00:17:00,Winnings,Bonus,8.0,1028.24
Fanduel,2022-03-25 00:30:00,Winnings,Bonus,8.0,1036.24
Fanduel,2022-03-25 17:16:00,Wager,,-8.0,1028.24
Fanduel,2022-03-25 19:06:00,Wager,,-8.0,1020.24
Fanduel,2022-03-25 19:09:00,Wager,,-8.0,1012.24
Fanduel,2022-03-25 19:13:00,Wager,,-8.0,1004.24
Fanduel,2022-03-25 20:28:00,Wager,,-5.0,999.24
Fanduel,2022-03-25 23:54:00,Winnings,Bonus,8.0,1007.24
Fanduel,2022-03-25 23:55:00,Winnings,Bonus,8.0,1015.24
Fanduel,2022-03-26 00:29:00,Winnings,Bonus,8.0,1023.24
Fanduel,2022-03-26 16:44:00,Wager,,-8.0,1015.24
Fanduel,2022-03-26 16:48:00,Wager,,-8.0,1007.24
Fanduel,2022-03-26 16:48:00,Wager,,-6.0,1001.24
Fanduel,2022-03-26 19:49:00,Wager,,-7.0,994.24
Fanduel,2022-03-26 20:22:00,Wager,,-7.0,987.24
Fanduel,2022-03-27 15:14:00,Winnings,Bonus,8.0,995.24
Fanduel,2022-03-27 17:55:00,Winnings,Bonus,7.0,1002.24
Fanduel,2022-03-27 19:12:00,Winnings,Bonus,6.0,1008.24
Fanduel,2022-03-27 19:25:00,Winnings,Bonus,4.0,1012.24
Fanduel,2022-03-28 20:56:00,Wager,,-20.0,992.24
Fanduel,2022-03-28 21:00:00,Wager,,-10.0,982.24
Fanduel,2022-03-28 21:01:00,Wager,,-10.0,972.24
Fanduel,2022-03-28 21:01:00,Winnings,,10.0,982.24
Fanduel,2022-03-28 21:01:00,Wager,,-10.0,972.24
Fanduel,2022-03-28 21:01:00,Winnings,,10.0,982.24
Fanduel,2022-03-28 21:01:00,Wager,,-10.0,972.24
Fanduel,2022-03-28 21:01:00,Winnings,,10.0,982.24
Fanduel,2022-03-28 21:01:00,Wager,,-10.0,972.24
Fanduel,2022-03-28 21:02:00,Winnings,,10.0,982.24
Fanduel,2022-03-28 21:03:00,Winnings,,8.0,982.24
Fanduel,2022-03-28 21:03:00,Wager,,-8.0,974.24
Fanduel,2022-03-28 21:03:00,Wager,,-10.0,972.24
Fanduel,2022-03-28 21:03:00,Winnings,,10.0,982.24
Fanduel,2022-03-28 21:42:00,Winnings,,10.05,992.29
Fanduel,2022-03-29 21:28:00,Winnings,Bonus,20.0,1012.29
Fanduel,2022-03-29 21:54:00,Wager,,-5.0,1007.29
Fanduel,2022-03-30 08:40:00,Wager,,-4.0,1003.29
Fanduel,2022-03-30 08:41:00,Winnings,,8.0,995.29
Fanduel,2022-03-30 08:41:00,Wager,,-8.0,995.29
Fanduel,2022-03-30 08:41:00,Wager,,-8.0,987.29
Fanduel,2022-03-30 08:41:00,Winnings,,8.0,1003.29
Fanduel,2022-03-30 17:01:00,Wager,,-25.0,986.14
Fanduel,2022-03-30 17:01:00,Winnings,,7.85,1011.14
Fanduel,2022-03-30 17:02:00,Wager,,-4.0,982.14
Fanduel,2022-03-31 00:58:00,Winnings,,8.4,990.54
Fanduel,2022-03-31 16:37:00,Wager,,-3.0,987.54
Fanduel,2022-03-31 19:27:00,Wager,,-10.0,977.54
Fanduel,2022-03-31 22:28:00,Winnings,Bonus,10.0,987.54
Fanduel,2022-04-01 14:07:00,Winnings,Bonus,25.0,1012.54
Fanduel,2022-04-01 19:27:00,Wager,,-25.0,987.54
Fanduel,2022-04-02 22:51:00,Winnings,,25.0,1012.54
Fanduel,2022-04-03 00:09:00,Wager,,-3.0,1009.54
Fanduel,2022-04-04 23:06:00,Wager,,-3.0,1006.54
Fanduel,2022-04-07 11:05:00,Wager,,-20.0,986.54
Fanduel,2022-04-07 15:39:00,Wager,,-4.0,982.54
Fanduel,2022-04-07 20:01:00,Winnings,Bonus,20.0,1002.54
Fanduel,2022-04-09 11:30:00,Wager,,-3.0,999.54
Fanduel,2022-04-09 19:20:00,Winnings,,7.8,1007.34
Fanduel,2022-04-10 12:50:00,Wager,,-20.0,987.34
Fanduel,2022-04-10 17:06:00,Winnings,Bonus,20.0,1007.34
Fanduel,2022-04-12 12:08:00,Wager,,-0.1,1007.24
Fanduel,2022-04-12 12:10:00,Wager,,-0.1,1007.14
Fanduel,2022-04-12 16:17:00,Wager,,-20.0,987.14
Fanduel,2022-04-13 14:29:00,Wager,,-1.0,986.14
Fanduel,2022-04-13 17:34:00,Wager,,-20.0,966.14
Fanduel,2022-04-14 16:31:00,Wager,,-4.14,962.0
Fanduel,2022-04-15 00:42:00,Winnings,,9.11,971.11
Fanduel,2022-04-15 18:37:00,Wager,,-10.0,961.11
Fanduel,2022-04-15 18:39:00,Wager,,-10.0,951.11
Fanduel,2022-04-16 12:06:00,Winnings,Bonus,10.0,961.11
Fanduel,2022-04-16 16:13:00,Wager,,-15.0,946.11
Fanduel,2022-04-16 21:30:00,Winnings,Bonus,15.0,961.11
Fanduel,2022-04-17 13:38:00,Wager,,-10.0,951.11
Fanduel,2022-04-17 13:40:00,Wager,,-8.0,943.11
Fanduel,2022-04-17 13:44:00,Wager,,-15.0,928.11
Fanduel,2022-04-17 13:46:00,Wager,,-15.0,913.11
Fanduel,2022-04-17 18:07:00,Winnings,,18.5,931.61
Fanduel,2022-04-17 22:32:00,Wager,,-2.0,929.61
Fanduel,2022-04-17 23:42:00,Winnings,,30.0,959.61
Fanduel,2022-04-18 18:01:00,Wager,,-3.61,956.0
Fanduel,2022-04-18 18:23:00,Winnings,Bonus,8.0,964.0
Fanduel,2022-04-19 00:08:00,Wager,,-4.0,960.0
Fanduel,2022-04-19 01:26:00,Winnings,,7.4,967.4
Fanduel,2022-04-19 18:46:00,Winnings,,10.4,977.8
Fanduel,2022-04-20 00:24:00,Wager,,-5.0,972.8
Fanduel,2022-04-20 00:28:00,Wager,,-8.0,964.8
Fanduel,2022-04-20 01:01:00,Winnings,,9.5,974.3
Fanduel,2022-04-20 08:46:00,Wager,,-4.0,970.3
Fanduel,2022-04-20 16:56:00,Wager,,-15.0,955.3
Fanduel,2022-04-20 22:07:00,Winnings,Bonus,15.0,970.3
Fanduel,2022-04-21 11:00:00,Wager,,-5.3,965.0
Fanduel,2022-04-21 17:24:00,Wager,,-4.0,961.0
Fanduel,2022-04-21 17:25:00,Wager,,-1.0,960.0
Fanduel,2022-04-22 01:06:00,Winnings,,11.0,971.0
Fanduel,2022-04-23 12:18:00,Wager,,-12.0,959.0
Fanduel,2022-04-23 12:19:00,Winnings,,12.0,971.0
Fanduel,2022-04-23 12:22:00,Wager,,-10.0,961.0
Fanduel,2022-04-24 01:19:00,Winnings,,51.92,1012.92
Fanduel,2022-04-24 01:19:00,Winnings,Bonus,10.0,1022.92
Fanduel,2022-04-24 12:58:00,Wager,,-5.0,1017.92
Fanduel,2022-04-24 12:58:00,Wager,,-5.0,1012.92
Fanduel,2022-04-24 12:58:00,Wager,,-5.0,1007.92
Fanduel,2022-04-24 21:45:00,Winnings,,12.5,1020.42
Fanduel,2022-04-25 13:11:00,Wager,,-15.0,1005.42
Fanduel,2022-04-27 12:06:00,Wager,,-1.0,1004.42
Fanduel,2022-04-27 21:10:00,Wager,,-13.0,991.42
Fanduel,2022-04-28 20:13:00,Winnings,Bonus,13.0,1004.42
Fanduel,2022-04-29 16:54:00,Wager,,-11.0,993.42
Fanduel,2022-04-29 17:10:00,Wager,,-2.42,991.0
Fanduel,2022-04-29 21:49:00,Wager,,-10.0,981.0
Fanduel,2022-04-29 21:50:00,Wager,,-2.0,979.0
Fanduel,2022-04-29 22:52:00,Winnings,Bonus,11.0,990.0
Fanduel,2022-04-30 17:35:00,Wager,,-3.0,987.0
Fanduel,2022-05-01 15:56:00,Wager,,-10.0,977.0
Fanduel,2022-05-01 21:17:00,Winnings,Bonus,10.0,987.0
Fanduel,2022-05-02 18:38:00,Wager,,-13.0,974.0
Fanduel,2022-05-05 19:27:00,Wager,,-11.0,963.0
Fanduel,2022-05-05 19:36:00,Wager,,-11.0,952.0
Fanduel,2022-05-06 00:50:00,Winnings,,24.75,976.75
Fanduel,2022-05-06 21:45:00,Winnings,Bonus,11.0,987.75
Fanduel,2022-05-07 17:51:00,Wager,,-10.0,977.75
Fanduel,2022-05-07 17:52:00,Wager,,-2.75,975.0
Fanduel,2022-05-07 23:12:00,Winnings,,20.0,995.0
Fanduel,2022-05-08 12:33:00,Wager,,-10.0,985.0
Fanduel,2022-05-08 21:22:00,Wager,,-4.0,981.0
Fanduel,2022-05-08 22:06:00,Winnings,,56.03,1037.03
Fanduel,2022-05-08 22:07:00,Winnings,Bonus,10.0,1047.03
Fanduel,2022-05-08 22:55:00,Wager,,-10.0,1037.03
Fanduel,2022-05-09 20:42:00,Wager,,-1.03,1036.0
Fanduel,2022-05-11 19:38:00,Wager,,-13.0,1023.0
Fanduel,2022-05-12 00:01:00,Winnings,Bonus,13.0,1036.0
Fanduel,2022-05-12 11:36:00,Wager,,-11.0,1025.0
Fanduel,2022-05-13 12:04:00,Wager,,-13.0,1012.0
Fanduel,2022-05-15 13:40:00,Wager,,-10.0,1002.0
Fanduel,2022-05-15 13:42:00,Wager,,-10.0,992.0
Fanduel,2022-05-15 16:57:00,Winnings,Bonus,10.0,1002.0
Fanduel,2022-05-15 18:12:00,Winnings,Bonus,10.0,1012.0
Fanduel,2022-05-19 10:30:00,Wager,,-10.0,1002.0
Fanduel,2022-05-19 16:53:00,Winnings,,30.0,1032.0
Fanduel,2022-05-20 15:51:00,Wager,,-10.0,1022.0
Fanduel,2022-05-20 15:52:00,Wager,,-10.0,1012.0
Fanduel,2022-05-20 22:16:00,Winnings,,27.0,1039.0
Fanduel,2022-05-21 21:14:00,Winnings,,0.33,1039.33
Fanduel,2022-05-22 13:42:00,Wager,,-10.0,1029.33
Fanduel,2022-05-22 21:41:00,Winnings,Bonus,10.0,1039.33
Fanduel,2022-05-24 19:09:00,Wager,,-10.0,1029.33
Fanduel,2022-05-24 23:03:00,Winnings,Bonus,10.0,1039.33
Fanduel,2022-05-26 17:06:00,Winnings,Bonus,50.0,1089.33
Fanduel,2022-05-28 21:00:00,Wager,,-10.0,1079.33
Fanduel,2022-05-28 21:06:00,Wager,,-50.0,1029.33
Fanduel,2022-05-29 07:07:00,Winnings,,49.02,1078.35
Fanduel,2022-05-30 01:01:00,Wager,,-10.0,1068.35
Fanduel,2022-05-30 01:05:00,Wager,,-5.0,1063.35
Fanduel,2022-05-30 01:07:00,Wager,,-5.0,1058.35
Fanduel,2022-05-30 17:07:00,Wager,,-3.35,1055.0
Fanduel,2022-05-30 18:02:00,Winnings,,51.52,1106.52
Fanduel,2022-05-30 21:28:00,Wager,,-10.0,1096.52
Fanduel,2022-05-31 17:37:00,Wager,,-3.52,1093.0
Fanduel,2022-06-01 13:55:00,Winnings,Bonus,10.0,1103.0
Fanduel,2022-06-02 19:17:00,Wager,,-5.0,1098.0
Fanduel,2022-06-02 19:20:00,Wager,,-13.0,1085.0
Fanduel,2022-06-02 23:31:00,Winnings,Bonus,13.0,1098.0
Fanduel,2022-06-03 13:53:00,Wager,,-12.0,1086.0
Fanduel,2022-06-03 15:59:00,Winnings,Bonus,12.0,1098.0
Fanduel,2022-06-05 18:53:00,Wager,,-10.0,1088.0
Fanduel,2022-06-05 23:07:00,Winnings,,53.7,1141.7
Fanduel,2022-06-05 23:07:00,Winnings,Bonus,10.0,1151.7
Fanduel,2022-06-06 17:55:00,Wager,,-11.0,1140.7
Fanduel,2022-06-07 01:11:00,Winnings,Bonus,11.0,1151.7
Fanduel,2022-06-07 17:09:00,Wager,,-10.0,1141.7
Fanduel,2022-06-08 19:24:00,Wager,,-13.0,1128.7
Fanduel,2022-06-08 23:35:00,Winnings,,26.0,1154.7
Fanduel,2022-06-09 18:33:00,Wager,,-12.0,1142.7
Fanduel,2022-06-10 17:00:00,Wager,,-10.0,1132.7
Fanduel,2022-06-10 17:32:00,Wager,,-15.0,1117.7
Fanduel,2022-06-10 23:31:00,Winnings,Bonus,15.0,1132.7
Fanduel,2022-06-11 11:04:00,Wager,,-12.0,1120.7
Fanduel,2022-06-11 17:48:00,Winnings,Bonus,12.0,1132.7
Fanduel,2022-06-12 10:27:00,Wager,,-10.0,1122.7
Fanduel,2022-06-12 10:28:00,Wager,,-11.0,1111.7
Fanduel,2022-06-12 10:31:00,Wager,,-12.0,1099.7
Fanduel,2022-06-12 22:23:00,Winnings,Bonus,10.0,1165.13
Fanduel,2022-06-12 22:23:00,Winnings,,55.43,1155.13
Fanduel,2022-06-13 15:41:00,Wager,,-15.0,1150.13
Fanduel,2022-06-13 15:44:00,Wager,,-10.0,1140.13
Fanduel,2022-06-13 22:55:00,Winnings,,16.0,1156.13
Fanduel,2022-06-14 09:10:00,Wager,,-1.13,1155.0
Fanduel,2022-06-14 22:35:00,Winnings,,2.35,1157.35
Fanduel,2022-06-21 18:22:00,Wager,,-7.35,1150.0
Fanduel,2022-06-25 14:07:00,Wager,,-15.0,1135.0
Fanduel,2022-06-25 15:46:00,Wager,,-5.0,1130.0
Fanduel,2022-06-25 17:43:00,Winnings,Bonus,15.0,1224.17
Fanduel,2022-06-25 17:43:00,Winnings,,79.17,1209.17
Fanduel,2022-06-26 12:23:00,Wager,,-10.0,1214.17
Fanduel,2022-06-26 19:23:00,Winnings,Bonus,10.0,1224.17
Fanduel,2022-06-28 19:30:00,Wager,,-10.0,1214.17
Fanduel,2022-06-28 22:48:00,Winnings,,23.0,1237.17
Fanduel,2022-06-29 17:23:00,Wager,,-2.17,1235.0
Fanduel,2022-07-01 09:24:00,Wager,,-15.0,1220.0
Fanduel,2022-07-02 15:36:00,Wager,,-25.0,1195.0
Fanduel,2022-07-03 15:06:00,Winnings,Bonus,25.0,1220.0
Fanduel,2022-07-05 16:54:00,Wager,,-25.0,1195.0
Fanduel,2022-07-05 16:57:00,Wager,,-25.0,1170.0
Fanduel,2022-07-06 12:29:00,Winnings,Bonus,10.0,1180.0
Fanduel,2022-07-07 19:02:00,Wager,,-10.0,1170.0
Fanduel,2022-07-07 23:10:00,Winnings,,20.5,1190.5
Fanduel,2022-07-14 16:35:00,Wager,,-25.0,1165.5
Fanduel,2022-07-15 11:40:00,Winnings,Bonus,24.0,1189.5
Fanduel,2022-07-15 19:10:00,Wager,,-24.0,1165.5
Fanduel,2022-07-18 19:14:00,Wager,,-5.5,1160.0
Fanduel,2022-07-18 19:14:00,Wager,,-5.5,1160.0
Fanduel,2022-07-18 19:14:00,Winnings,,5.5,1165.5
Fanduel,2022-07-21 02:49:00,Winnings,Bonus,15.0,1234.17
Fanduel,2022-07-21 02:49:00,Winnings,Bonus,59.17,1219.17
Fanduel,2022-07-22 17:58:00,Winnings,Bonus,-59.17,1175.0
Fanduel,2022-07-22 18:00:00,Winnings,Bonus,20.0,1195.0
Fanduel,2022-07-23 14:54:00,Wager,,-20.0,1175.0
Fanduel,2022-07-23 20:28:00,Winnings,Bonus,10.0,1185.0
Fanduel,2022-07-25 12:14:00,Winnings,Bonus,-15.0,1170.0
Fanduel,2022-07-25 20:33:00,Wager,,-10.0,1160.0
Fanduel,2022-07-26 19:52:00,Wager,,-20.0,1140.0
Fanduel,2022-07-29 16:57:00,Wager,,-2.0,1138.0
Fanduel,2022-07-29 17:01:00,Wager,,-8.0,1130.0
Fanduel,2022-07-31 20:26:00,Winnings,,12.0,1142.0
Fanduel,2022-08-05 12:50:00,Wager,,-2.0,1140.0
Fanduel,2022-08-05 13:04:00,Winnings,,2.0,1142.0
Fanduel,2022-08-05 13:04:00,Wager,,-2.0,1140.0
Fanduel,2022-08-06 22:34:00,Wager,,-10.0,1130.0
Fanduel,2022-08-07 12:19:00,Winnings,Bonus,10.0,1140.0
Fanduel,2022-08-12 16:58:00,Wager,,-10.0,1130.0
Fanduel,2022-08-12 17:00:00,Wager,,-10.0,1120.0
Fanduel,2022-08-12 23:10:00,Winnings,,20.0,1140.0
Fanduel,2022-08-13 11:53:00,Winnings,Bonus,10.0,1150.0
Fanduel,2022-08-17 23:29:00,Wager,,-10.0,1140.0
Fanduel,2022-08-18 16:04:00,Winnings,,17.5,1157.5
Fanduel,2022-08-20 15:51:00,Wager,,-7.5,1150.0
Fanduel,2022-08-23 19:59:00,Wager,,-10.0,1140.0
Fanduel,2022-08-23 20:00:00,Wager,,-5.0,1135.0
Fanduel,2022-08-23 20:02:00,Wager,,-25.0,1110.0
Fanduel,2022-08-23 22:44:00,Wager,,-20.0,1090.0
Fanduel,2022-08-23 23:21:00,Winnings,,31.0,1121.0
Fanduel,2022-08-25 14:50:00,Winnings,Bonus,15.0,1136.0
Fanduel,2022-08-28 11:59:00,Wager,,-15.0,1121.0
Fanduel,2022-08-28 23:15:00,Winnings,,23.25,1144.25
Fanduel,2022-09-01 16:42:00,Wager,,-25.0,1119.25
Fanduel,2022-09-02 00:05:00,Winnings,Bonus,25.0,1144.25
Fanduel,2022-09-04 23:46:00,Wager,,-50.0,1094.25
Fanduel,2022-09-07 15:14:00,Wager,,-25.0,1069.25
Fanduel,2022-09-08 20:09:00,Wager,,-3.25,1066.0
Fanduel,2022-09-09 14:40:00,Winnings,Bonus,5.0,1071.0
Fanduel,2022-09-10 17:58:00,Wager,,-25.0,1046.0
Fanduel,2022-09-10 23:18:00,Wager,,-5.0,1041.0
Fanduel,2022-09-11 16:12:00,Winnings,Bonus,25.0,1066.0
Fanduel,2022-09-11 19:21:00,Winnings,,50.0,1116.0
Fanduel,2022-09-11 19:41:00,Wager,,-25.0,1091.0
Fanduel,2022-09-12 19:31:00,Wager,,-1.0,1090.0
Fanduel,2022-09-15 20:15:00,Wager,,-10.0,1080.0
Fanduel,2022-09-15 23:14:00,Winnings,,50.6,1130.6
Fanduel,2022-09-16 00:12:00,Wager,,-1.6,1129.0
Fanduel,2022-09-17 17:10:00,Wager,,-10.0,1119.0
Fanduel,2022-09-17 17:14:00,Wager,,-20.0,1099.0
Fanduel,2022-09-17 17:28:00,Wager,,-1.0,1098.0
Fanduel,2022-09-18 02:11:00,Winnings,Bonus,10.0,1209.65
Fanduel,2022-09-18 02:11:00,Winnings,,101.65,1199.65
Fanduel,2022-09-18 13:54:00,Wager,,-10.0,1199.65
Fanduel,2022-09-18 16:15:00,Winnings,Bonus,10.0,1209.65
Fanduel,2022-09-18 20:35:00,Winnings,,17.64,1227.29
Fanduel,2022-09-19 19:09:00,Wager,,-10.0,1217.29
Fanduel,2022-09-20 11:50:00,Winnings,Bonus,5.0,1222.29
Fanduel,2022-09-22 12:16:00,Wager,,-10.0,1212.29
Fanduel,2022-09-22 12:20:00,Wager,,-5.0,1207.29
Fanduel,2022-09-22 23:30:00,Winnings,Bonus,10.0,1217.29
Fanduel,2022-09-23 00:18:00,Wager,,-20.0,1197.29
Fanduel,2022-09-23 19:21:00,Wager,,-20.0,1177.29
Fanduel,2022-09-24 18:51:00,Winnings,Bonus,10.0,1187.29
Fanduel,2022-09-24 20:54:00,Wager,,-10.0,1177.29
Fanduel,2022-09-24 22:58:00,Winnings,,18.7,1195.99
Fanduel,2022-09-25 12:13:00,Wager,,-10.0,1185.99
Fanduel,2022-09-25 13:09:00,Winnings,,21.5,1207.49
Fanduel,2022-09-25 16:19:00,Winnings,Bonus,20.0,1227.49
Fanduel,2022-09-25 17:51:00,Wager,,-10.0,1217.49
Fanduel,2022-09-25 19:42:00,Winnings,,35.0,1252.49
Fanduel,2022-09-29 19:53:00,Wager,,-20.0,1232.49
Fanduel,2022-09-29 20:14:00,Wager,,-4.49,1228.0
Fanduel,2022-09-29 23:26:00,Winnings,Bonus,20.0,1248.0
Fanduel,2022-10-01 11:44:00,Wager,,-5.0,1243.0
Fanduel,2022-10-01 11:49:00,Wager,,-3.0,1240.0
Fanduel,2022-10-01 11:53:00,Wager,,-5.0,1235.0
Fanduel,2022-10-01 12:06:00,Wager,,-5.0,1230.0
Fanduel,2022-10-01 12:52:00,Wager,,-20.0,1210.0
Fanduel,2022-10-01 13:15:00,Wager,,-20.0,1190.0
Fanduel,2022-10-01 19:33:00,Winnings,Bonus,5.0,1195.0
Fanduel,2022-10-01 21:38:00,Wager,,-4.0,1191.0
Fanduel,2022-10-02 01:49:00,Winnings,,16.64,1207.64
Fanduel,2022-10-02 01:50:00,Winnings,Bonus,5.0,1212.64
Fanduel,2022-10-02 02:53:00,Winnings,Bonus,4.0,1221.64
Fanduel,2022-10-02 02:53:00,Winnings,Bonus,5.0,1217.64
Fanduel,2022-10-02 10:30:00,Wager,,-20.0,1201.64
Fanduel,2022-10-02 12:37:00,Winnings,Bonus,20.0,1221.64
Fanduel,2022-10-02 15:56:00,Wager,,-19.0,1202.64
Fanduel,2022-10-02 15:56:00,Wager,,-20.0,1182.64
Fanduel,2022-10-02 19:13:00,Winnings,,45.6,1228.24
Fanduel,2022-10-02 20:18:00,Wager,,-5.24,1223.0
Fanduel,2022-10-02 23:29:00,Winnings,,14.15,1237.15
Fanduel,2022-10-02 23:29:00,Winnings,,30.0,1267.15
Fanduel,2022-10-03 13:02:00,Winnings,Bonus,5.0,1272.15
Fanduel,2022-10-06 14:04:00,Wager,,-20.0,1252.15
Fanduel,2022-10-06 23:50:00,Winnings,Bonus,20.0,1272.15
Fanduel,2022-10-07 11:43:00,Wager,,-7.0,1265.15
Fanduel,2022-10-07 11:44:00,Winnings,,7.0,1272.15
Fanduel,2022-10-07 11:45:00,Wager,,-7.0,1265.15
Fanduel,2022-10-07 11:48:00,Wager,,-7.0,1258.15
Fanduel,2022-10-07 11:52:00,Wager,,-5.0,1253.15
Fanduel,2022-10-07 11:58:00,Wager,,-5.0,1248.15
Fanduel,2022-10-07 13:53:00,Winnings,Bonus,20.0,1268.15
Fanduel,2022-10-07 22:10:00,Wager,,-5.0,1243.15
Fanduel,2022-10-07 22:10:00,Wager,,-20.0,1248.15
Fanduel,2022-10-07 23:13:00,Winnings,Bonus,7.0,1250.15
Fanduel,2022-10-07 23:13:00,Winnings,Bonus,5.0,1255.15
Fanduel,2022-10-08 11:58:00,Wager,,-6.0,1249.15
Fanduel,2022-10-08 12:00:00,Wager,,-5.0,1244.15
Fanduel,2022-10-08 12:02:00,Wager,,-6.0,1238.15
Fanduel,2022-10-08 13:48:00,Wager,,-5.0,1233.15
Fanduel,2022-10-08 18:04:00,Winnings,Bonus,6.0,1239.15
Fanduel,2022-10-08 23:20:00,Winnings,Bonus,5.0,1244.15
Fanduel,2022-10-09 00:30:00,Winnings,Bonus,6.0,1250.15
Fanduel,2022-10-09 11:50:00,Wager,,-12.0,1238.15
Fanduel,2022-10-09 11:55:00,Wager,,-20.0,1218.15
Fanduel,2022-10-09 11:55:00,Wager,,-17.0,1201.15
Fanduel,2022-10-09 12:02:00,Wager,,-10.0,1191.15
Fanduel,2022-10-09 12:03:00,Wager,,-4.15,1187.0
Fanduel,2022-10-09 12:16:00,Wager,,-8.0,1179.0
Fanduel,2022-10-09 16:07:00,Winnings,,18.0,1197.0
Fanduel,2022-10-09 19:19:00,Winnings,Bonus,10.0,1207.0
Fanduel,2022-10-09 20:04:00,Wager,,-10.0,1197.0
Fanduel,2022-10-09 20:04:00,Wager,,-2.0,1195.0
Fanduel,2022-10-09 20:36:00,Winnings,,34.0,1229.0
Fanduel,2022-10-10 12:43:00,Winnings,Bonus,5.0,1234.0
Fanduel,2022-10-10 19:52:00,Wager,,-5.0,1229.0
Fanduel,2022-10-10 19:53:00,Wager,,-9.0,1220.0
Fanduel,2022-10-12 23:58:00,Wager,,-10.0,1210.0
Fanduel,2022-10-13 23:34:00,Winnings,,50.19,1260.19
Fanduel,2022-10-15 11:49:00,Wager,,-2.0,1258.19
Fanduel,2022-10-15 18:19:00,Wager,,-4.0,1254.19
Fanduel,2022-10-15 19:38:00,Winnings,,10.39,1264.58
Fanduel,2022-10-16 00:31:00,Winnings,Bonus,4.0,1268.58
Fanduel,2022-10-16 11:23:00,Wager,,-8.0,1260.58
Fanduel,2022-10-16 11:25:00,Wager,,-6.58,1254.0
Fanduel,2022-10-16 12:18:00,Wager,,-10.0,1244.0
Fanduel,2022-10-16 12:19:00,Wager,,-4.0,1240.0
Fanduel,2022-10-16 16:27:00,Winnings,,50.85,1290.85
Fanduel,2022-10-16 16:27:00,Winnings,Bonus,10.0,1300.85
Fanduel,2022-10-16 16:47:00,Wager,,-8.85,1292.0
Fanduel,2022-10-16 16:48:00,Wager,,-10.0,1282.0
Fanduel,2022-10-16 17:26:00,Wager,,-3.0,1279.0
Fanduel,2022-10-16 17:27:00,Wager,,-3.0,1276.0
Fanduel,2022-10-16 19:36:00,Winnings,,18.94,1294.94
Fanduel,2022-10-16 19:41:00,Winnings,,14.48,1309.42
Fanduel,2022-10-16 20:05:00,Wager,,-6.42,1303.0
Fanduel,2022-10-16 23:25:00,Winnings,,15.41,1318.41
Fanduel,2022-10-16 23:30:00,Winnings,,25.0,1343.41
Fanduel,2022-10-17 13:17:00,Wager,,-5.0,1338.41
Fanduel,2022-10-17 13:17:00,Wager,,-3.41,1335.0
Fanduel,2022-10-17 14:33:00,Winnings,Bonus,5.0,1340.0
Fanduel,2022-10-17 23:35:00,Winnings,,15.0,1355.0
Fanduel,2022-10-19 20:23:00,Wager,,-20.0,1335.0
Fanduel,2022-10-20 00:42:00,Winnings,,102.28,1437.28
Fanduel,2022-10-20 18:04:00,Wager,,-10.0,1427.28
Fanduel,2022-10-20 18:17:00,Wager,,-7.28,1420.0
Fanduel,2022-10-20 20:16:00,Wager,,-3.0,1417.0
Fanduel,2022-10-20 22:16:00,Wager,,-6.0,1411.0
Fanduel,2022-10-20 22:59:00,Winnings,,11.31,1422.31
Fanduel,2022-10-20 23:34:00,Winnings,Bonus,10.0,1432.31
Fanduel,2022-10-22 17:39:00,Wager,,-5.0,1427.31
Fanduel,2022-10-23 01:52:00,Winnings,Bonus,5.0,1432.31
Fanduel,2022-10-23 12:47:00,Wager,,-5.0,1427.31
Fanduel,2022-10-23 12:51:00,Wager,,-10.0,1412.31
Fanduel,2022-10-23 12:51:00,Wager,,-5.0,1422.31
Fanduel,2022-10-23 12:54:00,Wager,,-5.31,1407.0
Fanduel,2022-10-23 19:33:00,Winnings,,13.89,1420.89
Fanduel,2022-10-23 19:38:00,Wager,,-8.89,1412.0
Fanduel,2022-10-23 19:44:00,Wager,,-4.0,1408.0
Fanduel,2022-10-23 23:33:00,Winnings,,23.11,1431.11
Fanduel,2022-10-24 19:50:00,Wager,,-11.11,1420.0
Fanduel,2022-10-24 23:27:00,Winnings,,22.22,1442.22
Fanduel,2022-10-27 19:11:00,Wager,,-8.22,1434.0
Fanduel,2022-10-27 19:13:00,Wager,,-10.0,1424.0
Fanduel,2022-10-27 23:29:00,Winnings,Bonus,10.0,1434.0
Fanduel,2022-10-28 00:01:00,Winnings,,20.55,1454.55
Fanduel,2022-10-28 19:39:00,Wager,,-4.0,1450.55
Fanduel,2022-10-28 23:34:00,Winnings,Bonus,4.0,1454.55
Fanduel,2022-10-29 01:51:00,Wager,,-4.0,1450.55
Fanduel,2022-10-29 01:54:00,Wager,,-5.0,1445.55
Fanduel,2022-10-29 01:57:00,Wager,,-10.0,1435.55
Fanduel,2022-10-29 01:59:00,Wager,,-4.0,1431.55
Fanduel,2022-10-30 03:03:00,Wager,,-4.55,1427.0
Fanduel,2022-10-30 12:03:00,Wager,,-6.0,1421.0
Fanduel,2022-10-30 12:05:00,Wager,,-4.0,1417.0
Fanduel,2022-10-30 12:06:00,Wager,,-5.0,1412.0
Fanduel,2022-10-30 12:07:00,Wager,,-5.0,1407.0
Fanduel,2022-10-30 12:30:00,Winnings,,9.56,1416.56
Fanduel,2022-10-30 13:26:00,Wager,,-8.0,1408.56
Fanduel,2022-10-30 14:22:00,Winnings,,9.17,1417.73
Fanduel,2022-10-30 15:39:00,Winnings,,8.0,1425.73
Fanduel,2022-10-30 16:11:00,Winnings,,14.25,1439.98
Fanduel,2022-10-30 19:17:00,Wager,,-10.0,1429.98
Fanduel,2022-10-30 19:27:00,Winnings,,12.17,1442.15
Fanduel,2022-10-30 19:29:00,Winnings,,12.0,1454.15
Fanduel,2022-10-30 23:29:00,Winnings,,22.0,1476.15
Fanduel,2022-10-31 12:14:00,Winnings,Bonus,5.0,1481.15
Fanduel,2022-10-31 19:40:00,Wager,,-8.15,1473.0
Fanduel,2022-11-01 20:06:00,Wager,,-5.0,1468.0
Fanduel,2022-11-01 20:09:00,Wager,,-6.0,1462.0
Fanduel,2022-11-02 00:38:00,Winnings,,26.77,1488.77
Fanduel,2022-11-02 20:11:00,Wager,,-3.77,1485.0
Fanduel,2022-11-03 19:07:00,Wager,,-5.0,1475.0
Fanduel,2022-11-03 19:07:00,Wager,,-1.0,1474.0
Fanduel,2022-11-03 19:07:00,Wager,,-5.0,1480.0
Fanduel,2022-11-03 19:11:00,Wager,,-4.0,1470.0
Fanduel,2022-11-03 20:24:00,Winnings,Bonus,5.0,1475.0
Fanduel,2022-11-03 22:39:00,Winnings,,10.81,1485.81
Fanduel,2022-11-04 10:38:00,Wager,,-20.0,1465.81
Fanduel,2022-11-04 10:39:00,Wager,,-3.0,1462.81
Fanduel,2022-11-05 12:08:00,Wager,,-6.81,1456.0
Fanduel,2022-11-05 12:12:00,Wager,,-20.0,1436.0
Fanduel,2022-11-05 12:14:00,Wager,,-10.0,1426.0
Fanduel,2022-11-06 01:22:00,Winnings,Bonus,10.0,1436.0
Fanduel,2022-11-06 10:30:00,Wager,,-10.0,1426.0
Fanduel,2022-11-06 10:34:00,Wager,,-8.0,1418.0
Fanduel,2022-11-06 10:47:00,Wager,,-5.0,1413.0
Fanduel,2022-11-06 11:24:00,Winnings,,8.41,1421.41
Fanduel,2022-11-06 11:24:00,Wager,,-6.0,1415.41
Fanduel,2022-11-06 11:25:00,Wager,,-2.41,1413.0
Fanduel,2022-11-06 14:24:00,Winnings,,14.06,1427.06
Fanduel,2022-11-06 16:10:00,Winnings,,11.73,1438.79
Fanduel,2022-11-06 16:30:00,Winnings,,21.0,1459.79
Fanduel,2022-11-06 20:17:00,Wager,,-8.0,1451.79
Fanduel,2022-11-07 20:07:00,Wager,,-3.79,1448.0
Fanduel,2022-11-07 23:07:00,Winnings,,26.83,1474.83
Fanduel,2022-11-09 19:19:00,Wager,,-3.83,1471.0
Fanduel,2022-11-10 17:56:00,Wager,,-5.0,1466.0
Fanduel,2022-11-10 21:31:00,Winnings,Bonus,5.0,1471.0
Fanduel,2022-11-11 18:47:00,Wager,,-3.0,1468.0
Fanduel,2022-11-12 00:43:00,Wager,,-20.0,1448.0
Fanduel,2022-11-12 00:46:00,Wager,,-1.0,1447.0
Fanduel,2022-11-12 00:53:00,Winnings,,2.62,1449.62
Fanduel,2022-11-12 00:57:00,Winnings,,13.5,1463.12
Fanduel,2022-11-12 19:03:00,Winnings,Bonus,10.0,1473.12
Fanduel,2022-11-13 12:32:00,Wager,,-5.0,1468.12
Fanduel,2022-11-13 12:36:00,Wager,,-10.0,1458.12
Fanduel,2022-11-13 12:37:00,Wager,,-8.12,1450.0
Fanduel,2022-11-13 20:16:00,Winnings,,22.33,1472.33
Fanduel,2022-11-14 20:08:00,Wager,,-5.33,1467.0
Fanduel,2022-11-15 20:06:00,Wager,,-5.0,1462.0
Fanduel,2022-11-16 00:25:00,Winnings,Bonus,5.0,1467.0
Fanduel,2022-11-17 20:13:00,Wager,,-5.0,1462.0
Fanduel,2022-11-17 21:47:00,Wager,,-3.0,1459.0
Fanduel,2022-11-17 21:52:00,Wager,,-4.0,1455.0
Fanduel,2022-11-17 23:18:00,Winnings,Bonus,5.0,1460.0
Fanduel,2022-11-18 18:40:00,Wager,,-5.0,1455.0
Fanduel,2022-11-18 22:50:00,Winnings,,10.0,1465.0
Fanduel,2022-11-19 11:53:00,Wager,,-5.0,1460.0
Fanduel,2022-11-19 11:56:00,Wager,,-20.0,1440.0
Fanduel,2022-11-19 19:20:00,Winnings,Bonus,10.0,1450.0
Fanduel,2022-11-20 12:57:00,Wager,,-5.0,1445.0
Fanduel,2022-11-20 12:57:00,Wager,,-5.0,1440.0
Fanduel,2022-11-20 12:58:00,Wager,,-4.0,1436.0
Fanduel,2022-11-20 16:06:00,Winnings,,10.0,1446.0
Fanduel,2022-11-20 16:24:00,Wager,,-10.0,1436.0
Fanduel,2022-11-20 23:21:00,Winnings,,16.93,1452.93
Fanduel,2022-11-21 15:45:00,Winnings,Bonus,5.0,1457.93
Fanduel,2022-11-22 12:50:00,Winnings,Bonus,5.0,1462.93
Fanduel,2022-11-24 11:41:00,Wager,,-5.0,1452.93
Fanduel,2022-11-24 11:41:00,Wager,,-5.0,1457.93
Fanduel,2022-11-24 11:42:00,Wager,,-7.93,1445.0
Fanduel,2022-11-24 11:44:00,Wager,,-2.0,1443.0
Fanduel,2022-11-24 11:50:00,Wager,,-15.0,1428.0
Fanduel,2022-11-24 11:54:00,Wager,,-5.0,1423.0
Fanduel,2022-11-24 18:26:00,Wager,,-12.0,1411.0
Fanduel,2022-11-24 19:35:00,Winnings,,15.86,1426.86
Fanduel,2022-11-24 19:56:00,Winnings,,26.38,1453.24
Fanduel,2022-11-25 11:55:00,Winnings,Bonus,5.0,1458.24
Fanduel,2022-11-25 15:51:00,Winnings,,26.4,1484.64
Fanduel,2022-11-26 11:45:00,Wager,,-5.0,1479.64
Fanduel,2022-11-26 11:45:00,Wager,,-7.64,1472.0
Fanduel,2022-11-26 11:51:00,Wager,,-5.0,1467.0
Fanduel,2022-11-26 19:34:00,Winnings,,10.55,1477.55
Fanduel,2022-11-27 10:56:00,Wager,,-7.55,1470.0
Fanduel,2022-11-27 17:51:00,Wager,,-5.0,1465.0
Fanduel,2022-11-27 23:34:00,Winnings,,11.25,1476.25
Fanduel,2022-11-28 05:30:00,Winnings,Bonus,2.0,1478.25
Fanduel,2022-11-28 19:59:00,Wager,,-6.25,1472.0
Fanduel,2022-11-28 22:31:00,Winnings,,14.06,1486.06
Fanduel,2022-11-29 14:37:00,Winnings,Bonus,10.0,1496.06
Fanduel,2022-11-29 16:02:00,Winnings,,9.55,1505.61
Fanduel,2022-11-29 20:47:00,Wager,,-5.0,1500.61
Fanduel,2022-11-29 20:48:00,Wager,,-10.0,1490.61
Fanduel,2022-11-30 00:57:00,Winnings,Bonus,5.0,1495.61
Fanduel,2022-11-30 20:50:00,Wager,,-8.61,1487.0
Fanduel,2022-11-30 20:56:00,Wager,,-5.0,1482.0
Fanduel,2022-11-30 22:34:00,Winnings,,11.0,1493.0
Fanduel,2022-11-30 22:43:00,Wager,,-4.0,1489.0
Fanduel,2022-11-30 22:43:00,Wager,,-4.0,1485.0
Fanduel,2022-12-01 00:30:00,Winnings,Bonus,50.0,1535.0
Fanduel,2022-12-01 00:47:00,Wager,,-5.0,1530.0
Fanduel,2022-12-01 00:51:00,Wager,,-4.0,1526.0
Fanduel,2022-12-01 00:54:00,Wager,,-4.0,1522.0
Fanduel,2022-12-01 00:57:00,Wager,,-5.0,1517.0
Fanduel,2022-12-01 17:36:00,Wager,,-50.0,1467.0
Fanduel,2022-12-01 23:12:00,Winnings,Bonus,5.0,1472.0
Fanduel,2022-12-02 13:54:00,Winnings,Bonus,5.0,1477.0
Fanduel,2022-12-03 11:53:00,Winnings,,21.41,1498.41
Fanduel,2022-12-03 12:32:00,Winnings,Bonus,5.0,1503.41
Fanduel,2022-12-03 13:37:00,Wager,,-5.0,1498.41
Fanduel,2022-12-03 13:40:00,Wager,,-5.0,1493.41
Fanduel,2022-12-04 10:35:00,Wager,,-5.0,1488.41
Fanduel,2022-12-04 10:36:00,Wager,,-5.0,1483.41
Fanduel,2022-12-04 10:41:00,Wager,,-2.0,1481.41
Fanduel,2022-12-04 16:01:00,Winnings,,59.7,1541.11
Fanduel,2022-12-11 12:25:00,Wager,,-14.0,1527.11
Fanduel,2022-12-12 19:48:00,Wager,,-7.11,1520.0
Fanduel,2022-12-13 11:36:00,Winnings,Bonus,5.0,1525.0
Fanduel,2022-12-17 13:04:00,Wager,,-5.0,1520.0
Fanduel,2022-12-18 16:19:00,Wager,,-5.0,1515.0
Fanduel,2022-12-18 16:19:00,Wager,,-5.0,1510.0
Fanduel,2022-12-18 20:10:00,Winnings,,20.0,1530.0
Fanduel,2022-12-18 23:30:00,Winnings,,20.0,1550.0
Fanduel,2022-12-19 17:39:00,Wager,,-3.0,1547.0
Fanduel,2022-12-19 17:40:00,Wager,,-3.0,1544.0
Fanduel,2022-12-19 17:44:00,Wager,,-3.0,1541.0
Fanduel,2022-12-19 17:46:00,Wager,,-3.0,1538.0
Fanduel,2022-12-19 23:16:00,Winnings,Bonus,3.0,1541.0
Fanduel,2022-12-19 23:17:00,Winnings,Bonus,3.0,1547.0
Fanduel,2022-12-19 23:17:00,Winnings,Bonus,3.0,1544.0
Fanduel,2022-12-19 23:28:00,Winnings,Bonus,3.0,1550.0
Fanduel,2022-12-21 19:11:00,Wager,,-12.0,1538.0
Fanduel,2022-12-23 21:40:00,Wager,,-18.0,1520.0
Fanduel,2022-12-24 00:45:00,Wager,,-4.0,1516.0
Fanduel,2022-12-24 00:45:00,Wager,,-2.0,1514.0
Fanduel,2022-12-31 11:02:00,Wager,,-7.0,1507.0
Fanduel,2023-01-01 10:44:00,Wager,,-7.0,1500.0
Fanduel,2023-01-01 10:46:00,Wager,,-10.0,1490.0
Fanduel,2023-01-01 19:03:00,Winnings,,13.92,1503.92
Fanduel,2023-01-05 17:00:00,Wager,,-5.0,1498.92
Fanduel,2023-01-05 17:04:00,Wager,,-15.92,1483.0
Fanduel,2023-01-05 21:06:00,Winnings,,32.8,1515.8
Fanduel,2023-01-05 21:53:00,Winnings,Bonus,5.0,1520.8
Fanduel,2023-01-08 12:53:00,Wager,,-5.0,1515.8
Fanduel,2023-01-08 12:58:00,Wager,,-5.8,1510.0
Fanduel,2023-01-08 17:58:00,Wager,,-10.0,1500.0
Fanduel,2023-01-09 19:33:00,Wager,,-5.0,1495.0
Fanduel,2023-01-12 20:01:00,Wager,,-5.0,1490.0
Fanduel,2023-01-13 00:58:00,Winnings,Bonus,5.0,1495.0
Fanduel,2023-01-14 15:47:00,Wager,,-10.0,1485.0
Fanduel,2023-01-14 19:56:00,Wager,,-10.0,1475.0
Fanduel,2023-01-15 13:00:00,Wager,,-5.0,1470.0
Fanduel,2023-01-15 16:19:00,Wager,,-10.0,1460.0
Fanduel,2023-01-15 16:23:00,Wager,,-8.0,1452.0
Fanduel,2023-01-15 16:24:00,Wager,,-8.0,1444.0
Fanduel,2023-01-15 22:59:00,Wager,,-5.0,1439.0
Fanduel,2023-01-16 15:35:00,Wager,,-7.0,1432.0
Fanduel,2023-01-16 19:10:00,Wager,,-12.0,1420.0
Fanduel,2023-01-16 22:17:00,Wager,,-5.0,1415.0
Fanduel,2023-01-16 22:18:00,Wager,,-3.0,1412.0
Fanduel,2023-01-16 22:27:00,Wager,,-3.45,1408.55
Fanduel,2023-01-16 22:28:00,Wager,,-1.0,1407.55
Fanduel,2023-01-16 22:35:00,Winnings,,8.45,1416.0
Fanduel,2023-01-16 22:50:00,Wager,,-2.55,1413.45
Fanduel,2023-01-16 23:41:00,Winnings,,14.0,1427.45
Fanduel,2023-01-17 12:19:00,Winnings,Bonus,25.0,1452.45
Fanduel,2023-01-19 21:44:00,Wager,,-5.0,1447.45
Fanduel,2023-01-20 00:47:00,Winnings,,25.76,1473.21
Fanduel,2023-01-21 16:08:00,Wager,,-5.0,1468.21
Fanduel,2023-01-21 16:10:00,Wager,,-7.21,1461.0
Fanduel,2023-01-21 19:37:00,Winnings,,25.82,1486.82
Fanduel,2023-01-22 12:53:00,Wager,,-4.82,1457.0
Fanduel,2023-01-22 12:53:00,Wager,,-25.0,1461.82
Fanduel,2023-01-22 16:06:00,Winnings,,50.0,1507.0
Fanduel,2023-01-22 16:09:00,Wager,,-50.0,1457.0
Fanduel,2023-01-24 20:31:00,Wager,,-2.0,1455.0
Fanduel,2023-01-25 01:11:00,Winnings,,4.5,1459.5
Fanduel,2023-01-26 01:53:00,Wager,,-10.0,1449.5
Fanduel,2023-01-26 01:56:00,Winnings,,10.0,1459.5
Fanduel,2023-01-27 14:14:00,Wager,,-4.5,1455.0
Fanduel,2023-01-27 21:40:00,Winnings,,6.03,1461.03
Fanduel,2023-01-28 10:44:00,Wager,,-5.0,1456.03
Fanduel,2023-01-28 21:22:00,Winnings,Bonus,5.0,1461.03
Fanduel,2023-01-29 11:10:00,Wager,,-5.0,1456.03
Fanduel,2023-01-29 11:13:00,Wager,,-5.0,1451.03
Fanduel,2023-01-29 11:16:00,Wager,,-6.03,1445.0
Fanduel,2023-01-29 18:08:00,Winnings,,22.39,1467.39
Fanduel,2023-01-29 18:11:00,Winnings,Bonus,5.0,1472.39
Fanduel,2023-01-29 22:23:00,Wager,,-20.0,1452.39
Fanduel,2023-02-04 11:36:00,Wager,,-5.0,1447.39
Fanduel,2023-02-04 11:38:00,Wager,,-5.0,1442.39
Fanduel,2023-02-04 11:40:00,Wager,,-2.39,1440.0
Fanduel,2023-02-04 11:40:00,Wager,,-5.0,1435.0
Fanduel,2023-02-04 11:41:00,Wager,,-5.0,1430.0
Fanduel,2023-02-04 15:34:00,Wager,,-5.0,1425.0
Fanduel,2023-02-04 21:33:00,Winnings,Bonus,5.0,1430.0
Fanduel,2023-02-04 23:03:00,Winnings,,18.5,1448.5
Fanduel,2023-02-07 20:09:00,Wager,,-50.0,1398.5
Fanduel,2023-02-07 20:09:00,Wager,,-50.0,1348.5
Fanduel,2023-02-07 20:14:00,Wager,,-1.5,1347.0
Fanduel,2023-02-07 20:17:00,Wager,,-5.0,1342.0
Fanduel,2023-02-08 00:31:00,Winnings,,100.0,1442.0
Fanduel,2023-02-08 20:55:00,Wager,,-5.0,1437.0
Fanduel,2023-02-11 11:15:00,Wager,,-5.0,1432.0
Fanduel,2023-02-12 12:57:00,Wager,,-15.0,1417.0
Fanduel,2023-02-12 12:57:00,Wager,,-15.0,1402.0
Fanduel,2023-02-12 13:11:00,Wager,,-30.0,1372.0
Fanduel,2023-02-12 22:20:00,Winnings,Bonus,5.0,1377.0
Fanduel,2023-02-13 05:45:00,Winnings,Bonus,5.0,1382.0
Fanduel,2023-02-14 19:55:00,Wager,,-5.0,1377.0
Fanduel,2023-02-15 21:50:00,Wager,,-5.0,1372.0
Fanduel,2023-02-16 01:43:00,Wager,,-10.0,1362.0
Fanduel,2023-02-16 18:28:00,Wager,,-5.0,1357.0
Fanduel,2023-02-16 18:30:00,Wager,,-5.0,1352.0
Fanduel,2023-02-16 21:59:00,Winnings,Bonus,5.0,1357.0
Fanduel,2023-02-18 13:02:00,Wager,,-10.0,1337.0
Fanduel,2023-02-18 13:02:00,Wager,,-10.0,1347.0
Fanduel,2023-02-18 23:34:00,Winnings,,21.0,1358.0
Fanduel,2023-02-19 13:00:00,Wager,,-5.0,1353.0
Fanduel,2023-02-22 18:42:00,Wager,,-1.0,1352.0
Fanduel,2023-02-22 23:37:00,Winnings,,3.0,1355.0
Fanduel,2023-03-02 10:06:00,Wager,,-5,1350
Fanduel,2023-03-02 20:15:00,Wager,,-10,1340
Fanduel,2023-03-02 22:07:00,Winnings,Bonus,5,1345
Fanduel,2023-03-02 23:12:00,Winnings,,15.68,1360.68
Fanduel,2023-03-02 23:26:00,Wager,,-5,1355.68
Fanduel,2023-03-04 00:27:00,Wager,,-10,1345.68
Fanduel,2023-03-04 00:28:00,Wager,,-10,1325.68
Fanduel,2023-03-04 00:28:00,Wager,,-10,1335.68
Fanduel,2023-03-04 22:09:00,Wager,,-50,1237.68
Fanduel,2023-03-04 22:09:00,Wager,,-1,1324.68
Fanduel,2023-03-04 22:09:00,Wager,,-37,1287.68
Fanduel,2023-03-04 22:26:00,Winnings,,21.7,1259.38
Fanduel,2023-03-05 00:55:00,Winnings,,150,1409.38
Fanduel,2023-03-05 01:14:00,Wager,,-6,1403.38
Fanduel,2023-03-05 01:19:00,Wager,,-7,1396.38
Fanduel,2023-03-05 15:08:00,Wager,,-10,1386.38
Fanduel,2023-03-05 15:08:00,Wager,,-10,1376.38
Fanduel,2023-03-05 22:49:00,Winnings,,30,1406.38
Fanduel,2023-03-06 17:49:00,Wager,,-6.38,1400
Fanduel,2023-03-06 21:07:00,Winnings,,22.2,1422.2
Fanduel,2023-03-07 21:50:00,Wager,,-7.2,1415
Fanduel,2023-03-08 19:52:00,Wager,,-5,1410
Fanduel,2023-03-09 11:50:00,Wager,,-6,1404
Fanduel,2023-03-09 11:52:00,Wager,,-5,1399
Fanduel,2023-03-10 00:41:00,Winnings,,25.27,1424.27
Fanduel,2023-03-10 12:26:00,Wager,,-8.27,1416
Fanduel,2023-03-10 14:25:00,Winnings,,23.98,1439.98
Fanduel,2023-03-11 12:43:00,Wager,,-16.98,1423
Fanduel,2023-03-11 12:44:00,Wager,,-3,1420
Fanduel,2023-03-11 15:17:00,Wager,,-10,1410
Fanduel,2023-03-12 12:12:00,Wager,,-10,1400
Fanduel,2023-03-14 20:59:00,Wager,,-5,1395
Fanduel,2023-03-15 19:55:00,Wager,,-8,1387
Fanduel,2023-03-16 13:30:00,Wager,,-5,1382
Fanduel,2023-03-16 13:30:00,Wager,,-4,1378
Fanduel,2023-03-16 14:46:00,Winnings,,18.51,1396.51
Fanduel,2023-03-17 00:45:00,Winnings,,24,1420.51
Fanduel,2023-03-17 00:45:00,Winnings,,12,1432.51
Fanduel,2023-03-17 09:57:00,Wager,,-5,1427.51
Fanduel,2023-03-17 11:01:00,Wager,,-4,1423.51
Fanduel,2023-03-17 11:02:00,Wager,,-2,1421.51
Fanduel,2023-03-17 11:03:00,Wager,,-8,1413.51
Fanduel,2023-03-17 11:06:00,Wager,,-4,1409.51
Fanduel,2023-03-17 18:51:00,Wager,,-4,1405.51
Fanduel,2023-03-17 22:06:00,Winnings,Bonus,2,1407.51
Fanduel,2023-03-17 22:07:00,Winnings,Bonus,4,1411.51
Fanduel,2023-03-18 00:04:00,Winnings,Bonus,8,1419.51
Fanduel,2023-03-18 00:09:00,Winnings,Bonus,4,1423.51
Fanduel,2023-03-18 14:02:00,Wager,,-5,1418.51
Fanduel,2023-03-18 14:04:00,Wager,,-3,1415.51
Fanduel,2023-03-18 14:05:00,Wager,,-5,1410.51
Fanduel,2023-03-18 18:09:00,Wager,,-32,1360.51
Fanduel,2023-03-18 18:09:00,Wager,,-18,1392.51
Fanduel,2023-03-18 18:10:00,Wager,,-6,1354.51
Fanduel,2023-03-18 18:10:00,Wager,,-10,1344.51
Fanduel,2023-03-18 20:06:00,Winnings,,60,1404.51
Fanduel,2023-03-18 20:53:00,Wager,,-5.51,1399
Fanduel,2023-03-18 21:12:00,Winnings,,0.17,1399.17
Fanduel,2023-03-18 22:18:00,Winnings,Bonus,3,1402.17
Fanduel,2023-03-19 00:19:00,Winnings,Bonus,5,1412.17
Fanduel,2023-03-19 00:19:00,Winnings,Bonus,5,1407.17
Fanduel,2023-03-19 11:20:00,Wager,,-13,1399.17
Fanduel,2023-03-19 14:51:00,Wager,,-7.17,1392
Fanduel,2023-03-19 14:52:00,Wager,,-5,1387
Fanduel,2023-03-19 14:54:00,Wager,,-5,1382
Fanduel,2023-03-19 14:54:00,Wager,,-4,1378
Fanduel,2023-03-19 20:18:00,Winnings,Bonus,5,1383
Fanduel,2023-03-19 21:58:00,Wager,,-6,1377
Fanduel,2023-03-19 22:14:00,Winnings,,12,1389
Fanduel,2023-03-20 00:13:00,Winnings,Bonus,5,1394
Fanduel,2023-03-21 20:36:00,Wager,,-10,1384
Fanduel,2023-03-23 20:41:00,Wager,,-10,1374
Fanduel,2023-03-23 20:50:00,Wager,,-5,1369
Fanduel,2023-03-23 21:11:00,Wager,,-7,1362
Fanduel,2023-03-24 01:09:00,Winnings,,27.5,1389.5
Fanduel,2023-03-24 18:39:00,Wager,,-8,1381.5
Fanduel,2023-03-24 18:42:00,Wager,,-5,1376.5
Fanduel,2023-03-24 18:44:00,Wager,,-5,1371.5
Fanduel,2023-03-24 20:55:00,Winnings,,27.77,1399.27
Fanduel,2023-03-24 21:29:00,Winnings,Bonus,7,1406.27
Fanduel,2023-03-25 00:15:00,Winnings,,27.24,1433.51
Fanduel,2023-03-25 00:15:00,Winnings,Bonus,8,1441.51
Fanduel,2023-03-25 18:10:00,Wager,,-5,1436.51
Fanduel,2023-03-25 18:11:00,Wager,,-7,1429.51
Fanduel,2023-03-25 18:12:00,Wager,,-3,1426.51
Fanduel,2023-03-25 18:13:00,Wager,,-5,1421.51
Fanduel,2023-03-25 18:14:00,Wager,,-15,1406.51
Fanduel,2023-03-25 20:34:00,Winnings,Bonus,5,1411.51
Fanduel,2023-03-26 13:55:00,Wager,,-5,1406.51
Fanduel,2023-03-26 16:39:00,Winnings,Bonus,7,1418.51
Fanduel,2023-03-26 16:39:00,Winnings,Bonus,5,1411.51
Fanduel,2023-03-26 19:10:00,Wager,,-12,1406.51
Fanduel,2023-03-26 19:15:00,Winnings,,12.5,1419.01
Fanduel,2023-03-26 19:30:00,Winnings,Bonus,5,1424.01
Fanduel,2023-03-26 19:30:00,Winnings,Bonus,3,1427.01
Fanduel,2023-03-27 14:42:00,Wager,,-1,1426.01
Fanduel,2023-03-27 23:40:00,Winnings,,1,1427.01
Fanduel,2023-03-29 21:17:00,Wager,,-8,1419.01
Fanduel,2023-03-30 13:18:00,Wager,,-5,1414.01
Fanduel,2023-03-30 16:44:00,Winnings,Bonus,5,1419.01
Fanduel,2023-03-30 17:47:00,Wager,,-10,1409.01
Fanduel,2023-03-30 17:47:00,Wager,,-10,1399.01
Fanduel,2023-03-30 20:01:00,Winnings,,17.6,1416.61
Fanduel,2023-03-30 22:07:00,Winnings,,38,1454.61
Fanduel,2023-03-31 11:50:00,Wager,,-15.61,1439
Fanduel,2023-03-31 11:54:00,Wager,,-14,1425
Fanduel,2023-03-31 19:51:00,Wager,,-5,1420
Fanduel,2023-03-31 19:51:00,Wager,,-5,1415
Fanduel,2023-03-31 23:53:00,Winnings,,8,1423
Fanduel,2023-04-01 13:10:00,Wager,,-5,1418
Fanduel,2023-04-01 13:10:00,Wager,,-5,1413
Fanduel,2023-04-01 16:58:00,Winnings,,30.57,1443.57
Fanduel,2023-04-01 16:59:00,Winnings,Bonus,5,1448.57
Fanduel,2023-04-01 19:14:00,Wager,,-5,1443.57
Fanduel,2023-04-01 22:49:00,Winnings,,20,1463.57
Fanduel,2023-04-02 00:23:00,Winnings,,7.96,1471.53
Fanduel,2023-04-02 00:50:00,Winnings,,-7.96,1463.57
Fanduel,2023-04-02 00:51:00,Winnings,,15.92,1479.49
Fanduel,2023-04-02 12:53:00,Wager,,-10,1469.49
Fanduel,2023-04-02 13:13:00,Wager,,-25,1444.49
Fanduel,2023-04-02 13:24:00,Wager,,-25,1419.49
Fanduel,2023-04-02 13:27:00,Wager,,-25,1394.49
Fanduel,2023-04-02 13:28:00,Wager,,-4.49,1390
Fanduel,2023-04-02 16:47:00,Winnings,,9.75,1399.75
Fanduel,2023-04-02 18:40:00,Winnings,,119,1518.75
Fanduel,2023-04-02 21:33:00,Winnings,,104,1622.75
Fanduel,2023-04-02 21:36:00,Winnings,,25,1647.75
Fanduel,2023-04-03 14:27:00,Wager,,-10,1637.75
Fanduel,2023-04-03 14:35:00,Wager,,-25,1612.75
Fanduel,2023-04-03 14:35:00,Winnings,,10,1622.75
Fanduel,2023-04-03 14:36:00,Wager,,-8,1614.75
Fanduel,2023-04-03 14:37:00,Wager,,-3.75,1611
Fanduel,2023-04-03 19:46:00,Wager,,-15,1596
Fanduel,2023-04-03 23:46:00,Winnings,,37.5,1633.5
Fanduel,2023-04-05 13:00:00,Wager,,-13.5,1620
Fanduel,2023-04-06 01:38:00,Wager,,-15,1605
Fanduel,2023-04-06 01:42:00,Wager,,-13,1579
Fanduel,2023-04-06 01:42:00,Wager,,-13,1592
Fanduel,2023-04-07 11:52:00,Wager,,-15,1564
Fanduel,2023-04-07 11:54:00,Wager,,-15,1549
Fanduel,2023-04-07 22:26:00,Winnings,,58.2,1607.2
Fanduel,2023-04-08 10:52:00,Winnings,,32.5,1639.7
Fanduel,2023-04-08 11:11:00,Wager,,-50,1589.7
Fanduel,2023-04-08 11:11:00,Wager,,-6,1583.7
Fanduel,2023-04-08 11:11:00,Wager,,-0.7,1583
Fanduel,2023-04-09 00:54:00,Winnings,,110,1693
Fanduel,2023-04-09 20:08:00,Winnings,,25.35,1718.35
