Book,Time,Action,Bonus,Change,Book Balance,Net Balance
Fanduel,2021-04-01 14:48:00,Deposit,,50.0,50.0,50.0
Fanduel,2021-04-01 15:11:00,Wager,,-5.0,45.0,45.0
Fanduel,2021-04-01 15:23:00,Winnings,Bonus,50.0,95.0,95.0
Fanduel,2021-04-01 15:29:00,Wager,,-10.0,85.0,85.0
Fanduel,2021-04-02 12:45:00,Winnings,Bonus,10.0,95.0,95.0
Fanduel,2021-04-03 23:23:00,Winnings,,5.45,100.45,100.45
Fanduel,2021-04-04 17:44:00,Wager,,-10.0,90.45,90.45
Fanduel,2021-04-05 11:09:00,Winnings,Bonus,10.0,100.45,100.45
Fanduel,2021-04-05 17:24:00,Wager,,-10.0,90.45,90.45
Fanduel,2021-04-05 23:30:00,Winnings,,26.8,117.25,117.25
Fanduel,2021-04-06 17:22:00,Winnings,Bonus,195.0,312.25,312.25
Fanduel,2021-04-08 11:57:00,Wager,,-5.0,307.25,307.25
Fanduel,2021-04-08 11:58:00,Wager,,-5.0,302.25,302.25
Fanduel,2021-04-08 19:23:00,Winnings,,10.8,313.05,313.05
Fanduel,2021-04-11 15:30:00,Wager,,-0.1,312.95,312.95
Fanduel,2021-04-17 20:56:00,Wager,,-6.85,306.1,306.1
Fanduel,2021-04-18 10:42:00,Wager,,-2.5,303.6,303.6
Fanduel,2021-04-18 16:47:00,Wager,,-5.0,298.6,298.6
Fanduel,2021-04-18 22:21:00,Winnings,,13.0,311.6,311.6
Fanduel,2021-04-19 17:23:00,Wager,,-2.0,309.6,309.6
Fanduel,2021-04-20 16:28:00,Wager,,-8.0,301.6,301.6
Fanduel,2021-04-24 11:25:00,Wager,,-5.0,296.6,296.6
Fanduel,2021-04-24 19:09:00,Winnings,,8.97,305.57,305.57
Fanduel,2021-04-26 14:31:00,Wager,,-5.0,300.57,300.57
Fanduel,2021-04-27 16:55:00,Wager,,-5.0,295.57,295.57
Fanduel,2021-04-27 23:11:00,Winnings,,9.1,304.67,304.67
Fanduel,2021-04-28 16:59:00,Wager,,-5.0,299.67,299.67
Fanduel,2021-04-28 21:34:00,Wager,,-5.0,294.67,294.67
Fanduel,2021-04-28 21:45:00,Winnings,,2.3,296.97,296.97
Fanduel,2021-04-28 23:07:00,Winnings,,13.25,310.22,310.22
Fanduel,2021-04-29 22:22:00,Wager,,-25.0,285.22,285.22
Fanduel,2021-04-29 22:24:00,Winnings,,25.0,310.22,310.22
Fanduel,2021-04-29 22:24:00,Wager,,-25.0,285.22,285.22
Fanduel,2021-04-29 22:24:00,Winnings,Bonus,10.0,295.22,295.22
Fanduel,2021-05-04 00:15:00,Wager,,-5.0,290.22,290.22
Fanduel,2021-05-04 20:27:00,Wager,,5.0,295.22,295.22
Fanduel,2021-05-06 11:35:00,Wager,,-5.0,290.22,290.22
Fanduel,2021-05-07 14:00:00,Wager,,-5.0,285.22,285.22
Fanduel,2021-05-11 15:40:00,Wager,,-5.0,280.22,280.22
Fanduel,2021-05-11 23:37:00,Winnings,,10.7,290.92,290.92
Fanduel,2021-05-12 16:24:00,Wager,,-5.0,285.92,285.92
Fanduel,2021-05-14 12:47:00,Wager,,-5.0,280.92,280.92
Fanduel,2021-05-14 14:32:00,Wager,,-2.0,278.92,278.92
Fanduel,2021-05-16 18:48:00,Wager,,-3.0,275.92,275.92
Fanduel,2021-05-19 18:56:00,Wager,,-10.0,265.92,265.92
Fanduel,2021-05-20 00:42:00,Winnings,Bonus,10.0,275.92,275.92
Fanduel,2021-05-21 12:52:00,Wager,,-5.0,270.92,270.92
Fanduel,2021-05-22 10:39:00,Wager,,-5.0,265.92,265.92
Fanduel,2021-05-22 22:04:00,Winnings,,9.63,275.55,275.55
Fanduel,2021-05-23 10:47:00,Wager,,-4.0,271.55,271.55
Fanduel,2021-05-23 15:45:00,Winnings,,7.64,279.19,279.19
Fanduel,2021-05-23 18:07:00,Winnings,,4.0,279.19,279.19
Fanduel,2021-05-23 18:07:00,Wager,,-4.0,275.19,275.19
Fanduel,2021-05-23 18:08:00,Wager,,-2.0,277.19,277.19
Fanduel,2021-05-25 11:24:00,Wager,,-5.0,272.19,272.19
Fanduel,2021-06-06 12:41:00,Wager,,-5.0,267.19,267.19
Fanduel,2021-06-12 09:43:00,Wager,,-15.0,252.19,252.19
Fanduel,2021-07-01 12:29:00,Wager,,-5.0,247.19,247.19
Fanduel,2021-07-09 16:31:00,Wager,,-2.0,245.19,245.19
Fanduel,2021-07-10 14:14:00,Wager,,-10.0,235.19,235.19
Fanduel,2021-07-11 00:32:00,Winnings,,17.94,253.13,253.13
Fanduel,2021-07-23 21:16:00,Wager,,-3.0,250.13,250.13
Fanduel,2021-08-23 12:34:00,Winnings,Bonus,-85.55,164.58,164.58
Fanduel,2021-08-26 10:59:00,Winnings,Bonus,5.0,169.58,169.58
Fanduel,2021-08-28 17:59:00,Wager,,-10.0,159.58,159.58
Fanduel,2021-08-28 18:01:00,Winnings,,10.0,169.58,169.58
Fanduel,2021-08-28 18:04:00,Wager,,-10.0,159.58,159.58
Fanduel,2021-08-28 21:02:00,Winnings,Bonus,10.0,169.58,169.58
Fanduel,2021-09-01 21:28:00,Wager,,-10.0,159.58,159.58
Fanduel,2021-09-02 11:55:00,Winnings,Bonus,-5.0,154.58,154.58
Fanduel,2021-09-04 22:50:00,Winnings,Bonus,10.0,164.58,164.58
Fanduel,2021-09-07 10:26:00,Wager,,-50.0,114.58,114.58
Fanduel,2021-09-07 10:31:00,Wager,,-10.0,104.58,104.58
Fanduel,2021-09-11 18:28:00,Winnings,Bonus,150.0,254.58,254.58
Fanduel,2021-09-12 23:12:00,Winnings,Bonus,10.0,264.58,264.58
Fanduel,2021-09-13 14:40:00,Wager,,-10.0,254.58,254.58
Fanduel,2021-09-13 22:53:00,Winnings,,19.26,273.84,273.84
Fanduel,2021-09-15 17:51:00,Wager,,-5.0,268.84,268.84
Fanduel,2021-09-15 22:51:00,Winnings,,12.5,281.34,281.34
Fanduel,2021-09-17 13:33:00,Wager,,-1.0,280.34,280.34
Fanduel,2021-09-19 11:17:00,Wager,,-10.0,270.34,270.34
Fanduel,2021-09-19 11:20:00,Wager,,-10.0,260.34,260.34
Fanduel,2021-09-19 14:45:00,Winnings,,19.52,279.86,279.86
Fanduel,2021-09-19 15:57:00,Winnings,Bonus,10.0,289.86,289.86
Fanduel,2021-09-20 12:07:00,Winnings,Bonus,5.0,294.86,294.86
Fanduel,2021-09-21 12:11:00,Wager,,-0.86,294.0,294.0
Fanduel,2021-09-23 09:06:00,Wager,,-10.0,284.0,284.0
Fanduel,2021-09-23 17:43:00,Winnings,,19.8,303.8,303.8
Fanduel,2021-09-24 10:12:00,Wager,,-5.0,298.8,298.8
Fanduel,2021-09-24 10:13:00,Wager,,-3.0,295.8,295.8
Fanduel,2021-09-24 17:00:00,Winnings,,8.42,304.22,304.22
Fanduel,2021-09-24 17:57:00,Winnings,,3.0,307.22,307.22
Fanduel,2021-09-24 17:58:00,Wager,,-5.0,302.22,302.22
Fanduel,2021-09-24 18:10:00,Wager,,-5.0,297.22,297.22
Fanduel,2021-09-24 18:11:00,Wager,,-5.0,292.22,292.22
Fanduel,2021-09-24 22:47:00,Winnings,,9.55,301.77,301.77
Fanduel,2021-09-25 12:59:00,Wager,,-10.0,291.77,291.77
Fanduel,2021-09-25 17:04:00,Winnings,,9.46,301.23,301.23
Fanduel,2021-09-25 17:40:00,Winnings,,19.52,320.75,320.75
Fanduel,2021-09-25 19:29:00,Wager,,-10.0,310.75,310.75
Fanduel,2021-09-25 19:36:00,Wager,,-20.0,290.75,290.75
Fanduel,2021-09-26 09:44:00,Winnings,,20.0,310.75,310.75
Fanduel,2021-09-26 09:48:00,Wager,,-20.0,290.75,290.75
Fanduel,2021-09-26 10:59:00,Wager,,-7.0,283.75,283.75
Fanduel,2021-09-26 16:08:00,Winnings,Bonus,10.0,293.75,293.75
Fanduel,2021-09-26 16:09:00,Winnings,Bonus,10.0,303.75,303.75
Fanduel,2021-09-26 17:56:00,Winnings,,13.67,317.42,317.42
Fanduel,2021-09-27 08:53:00,Wager,,-10.0,307.42,307.42
Fanduel,2021-09-27 11:13:00,Winnings,Bonus,5.0,312.42,312.42
Fanduel,2021-09-27 23:27:00,Winnings,,18.47,330.89,330.89
Fanduel,2021-09-28 00:05:00,Wager,,-7.0,323.89,323.89
Fanduel,2021-09-28 09:30:00,Wager,,-3.0,320.89,320.89
Fanduel,2021-09-28 21:39:00,Winnings,,5.31,326.2,326.2
Fanduel,2021-09-28 22:42:00,Winnings,,14.28,340.48,340.48
Fanduel,2021-09-29 11:57:00,Wager,,-9.0,331.48,331.48
Fanduel,2021-09-29 21:40:00,Wager,,-0.48,331.0,331.0
Fanduel,2021-10-02 23:02:00,Wager,,-10.0,321.0,321.0
Fanduel,2021-10-03 00:24:00,Wager,,-1.5,319.5,319.5
Fanduel,2021-10-03 16:35:00,Winnings,,52.17,371.67,371.67
Fanduel,2021-10-04 13:32:00,Winnings,Bonus,5.0,376.67,376.67
Fanduel,2021-10-05 12:59:00,Wager,,-20.0,356.67,356.67
Fanduel,2021-10-05 23:26:00,Winnings,,53.39,410.06,410.06
Fanduel,2021-10-05 23:27:00,Winnings,Bonus,10.0,420.06,420.06
Fanduel,2021-10-05 23:38:00,Wager,,-1.16,418.9,418.9
Fanduel,2021-10-08 12:09:00,Wager,,-20.0,398.9,398.9
Fanduel,2021-10-09 11:32:00,Wager,,-10.0,388.9,388.9
Fanduel,2021-10-09 11:33:00,Wager,,-7.5,381.4,381.4
Fanduel,2021-10-10 16:25:00,Winnings,,7.5,388.9,388.9
Fanduel,2021-10-10 19:21:00,Winnings,Bonus,10.0,398.9,398.9
Fanduel,2021-10-10 19:45:00,Wager,,-20.0,378.9,378.9
Fanduel,2021-10-10 19:46:00,Winnings,,20.0,398.9,398.9
Fanduel,2021-10-10 19:47:00,Wager,,-20.0,378.9,378.9
Fanduel,2021-10-11 00:37:00,Winnings,,105.98,484.88,484.88
Fanduel,2021-10-11 00:38:00,Winnings,Bonus,10.0,494.88,494.88
Fanduel,2021-10-11 11:20:00,Winnings,Bonus,5.0,499.88,499.88
Fanduel,2021-10-11 13:27:00,Wager,,-0.88,499.0,499.0
Fanduel,2021-10-11 23:33:00,Winnings,,2.9,501.9,501.9
Fanduel,2021-10-12 13:41:00,Wager,,-0.9,501.0,501.0
Fanduel,2021-10-14 09:28:00,Wager,,-20.0,481.0,481.0
Fanduel,2021-10-14 16:52:00,Wager,,-1.0,480.0,480.0
Fanduel,2021-10-17 01:28:00,Wager,,-10.0,470.0,470.0
Fanduel,2021-10-17 01:29:00,Wager,,-5.0,465.0,465.0
Fanduel,2021-10-17 01:31:00,Wager,,-5.0,460.0,460.0
Fanduel,2021-10-17 10:19:00,Wager,,-10.0,450.0,450.0
Fanduel,2021-10-17 16:06:00,Winnings,,11.54,461.54,461.54
Fanduel,2021-10-17 16:15:00,Winnings,Bonus,10.0,471.54,471.54
Fanduel,2021-10-17 18:21:00,Winnings,,0.35,471.89,471.89
Fanduel,2021-10-17 18:55:00,Wager,,-10.0,461.89,461.89
Fanduel,2021-10-18 23:24:00,Winnings,Bonus,10.0,471.89,471.89
Fanduel,2021-10-19 19:48:00,Wager,,-10.0,461.89,461.89
Fanduel,2021-10-20 21:36:00,Winnings,Bonus,10.0,471.89,471.89
Fanduel,2021-10-21 18:35:00,Wager,,-1.89,470.0,470.0
Fanduel,2021-10-22 19:01:00,Wager,,-4.0,466.0,466.0
Fanduel,2021-10-22 19:03:00,Wager,,-1.0,465.0,465.0
Fanduel,2021-10-22 22:19:00,Winnings,,3.55,468.55,468.55
Fanduel,2021-10-23 10:35:00,Wager,,-8.55,460.0,460.0
Fanduel,2021-10-23 20:12:00,Wager,,-20.0,440.0,440.0
Fanduel,2021-10-23 21:39:00,Wager,,-10.0,430.0,430.0
Fanduel,2021-10-24 16:02:00,Wager,,-5.0,425.0,425.0
Fanduel,2021-10-24 16:18:00,Winnings,Bonus,10.0,435.0,435.0
Fanduel,2021-10-24 23:25:00,Wager,,-39.5,395.5,395.5
Fanduel,2021-10-24 23:27:00,Wager,,-52.28,343.22,343.22
Fanduel,2021-10-25 23:19:00,Winnings,,137.06,480.28,480.28
Fanduel,2021-10-25 23:21:00,Winnings,Bonus,10.0,490.28,490.28
Fanduel,2021-10-26 12:54:00,Wager,,-10.0,480.28,480.28
Fanduel,2021-10-26 13:05:00,Wager,,-10.0,470.28,470.28
Fanduel,2021-10-26 15:19:00,Wager,,-10.01,460.27,460.27
Fanduel,2021-10-26 15:23:00,Wager,,-2.27,458.0,458.0
Fanduel,2021-10-26 15:23:00,Wager,,-3.0,455.0,455.0
Fanduel,2021-10-27 00:10:00,Wager,,-4.73,450.27,450.27
Fanduel,2021-10-27 00:22:00,Winnings,Bonus,10.0,460.27,460.27
Fanduel,2021-10-27 00:33:00,Winnings,,8.61,468.88,468.88
Fanduel,2021-10-28 15:07:00,Winnings,Bonus,10.0,478.88,478.88
Fanduel,2021-10-29 15:46:00,Wager,,-10.0,468.88,468.88
Fanduel,2021-10-29 15:54:00,Wager,,-25.0,443.88,443.88
Fanduel,2021-10-29 19:43:00,Wager,,-5.0,438.88,438.88
Fanduel,2021-10-29 23:26:00,Winnings,Bonus,10.0,448.88,448.88
Fanduel,2021-10-30 15:45:00,Wager,,-20.0,428.88,428.88
Fanduel,2021-10-30 15:47:00,Wager,,-5.0,423.88,423.88
Fanduel,2021-10-30 15:48:00,Wager,,-10.0,413.88,413.88
Fanduel,2021-10-30 15:50:00,Wager,,-5.0,408.88,408.88
Fanduel,2021-10-30 19:55:00,Winnings,Bonus,25.0,433.88,433.88
Fanduel,2021-10-31 13:48:00,Wager,,-7.0,426.88,426.88
Fanduel,2021-10-31 15:34:00,Wager,,-5.0,421.88,421.88
Fanduel,2021-10-31 16:14:00,Winnings,,11.11,432.99,432.99
Fanduel,2021-10-31 16:19:00,Winnings,,16.66,480.67,480.67
Fanduel,2021-10-31 16:19:00,Winnings,Bonus,10.0,452.71,452.71
Fanduel,2021-10-31 16:19:00,Winnings,,11.3,464.01,464.01
Fanduel,2021-10-31 16:19:00,Winnings,,9.72,473.73,473.73
Fanduel,2021-10-31 16:21:00,Wager,,-10.0,470.67,470.67
Fanduel,2021-10-31 16:36:00,Winnings,,11.5,482.17,482.17
Fanduel,2021-10-31 16:56:00,Wager,,-3.0,479.17,479.17
Fanduel,2021-10-31 19:35:00,Wager,,-1.0,478.17,478.17
Fanduel,2021-10-31 19:36:00,Winnings,Bonus,10.0,488.17,488.17
Fanduel,2021-10-31 19:40:00,Winnings,,5.73,493.9,493.9
Fanduel,2021-11-01 14:19:00,Winnings,Bonus,5.0,498.9,498.9
Fanduel,2021-11-02 15:26:00,Wager,,-10.0,488.9,488.9
Fanduel,2021-11-02 21:05:00,Wager,,-20.0,468.9,468.9
Fanduel,2021-11-02 21:54:00,Winnings,Bonus,10.0,478.9,478.9
Fanduel,2021-11-02 21:55:00,Winnings,,23.85,502.75,502.75
Fanduel,2021-11-03 19:09:00,Wager,,-2.75,500.0,500.0
Fanduel,2021-11-04 20:12:00,Wager,,-6.5,493.5,493.5
Draftkings,2021-11-07 10:00:00,Deposit,,150.0,150.0,643.5
Draftkings,2021-11-07 10:03:00,Wager,,-5.0,145.0,638.5
Fanduel,2021-11-07 10:28:00,Wager,,-20.0,473.5,618.5
Fanduel,2021-11-07 15:44:00,Wager,,-10.0,463.5,608.5
Fanduel,2021-11-07 15:47:00,Wager,,-9.75,453.75,598.75
Fanduel,2021-11-07 15:51:00,Wager,,-10.0,433.75,578.75
Fanduel,2021-11-07 15:51:00,Wager,,-10.0,443.75,588.75
Fanduel,2021-11-07 16:05:00,Winnings,,16.16,449.91,594.91
Fanduel,2021-11-07 16:06:00,Winnings,Bonus,10.0,459.91,604.91
Fanduel,2021-11-07 16:12:00,Winnings,,18.2,478.11,623.11
Fanduel,2021-11-07 16:12:00,Winnings,,14.88,492.99,637.99
Fanduel,2021-11-07 16:12:00,Winnings,,14.65,507.64,652.64
Fanduel,2021-11-07 16:22:00,Wager,,-10.0,497.64,642.64
Fanduel,2021-11-07 17:34:00,Wager,,-10.0,487.64,632.64
Fanduel,2021-11-07 19:33:00,Winnings,Bonus,10.0,497.64,642.64
Fanduel,2021-11-07 19:37:00,Winnings,,18.7,516.34,661.34
Draftkings,2021-11-07 20:19:00,Wager,,-10.0,135.0,651.34
Draftkings,2021-11-08 13:27:00,Wager,,-7.0,128.0,644.34
Draftkings,2021-11-08 18:50:00,Wager,,-10.0,118.0,634.34
Fanduel,2021-11-08 22:57:00,Wager,,-5.0,511.34,629.34
Draftkings,2021-11-08 23:48:00,Winnings,,23.45,141.45,652.79
Draftkings,2021-11-08 23:48:00,Winnings,,8.22,149.67,661.01
Draftkings,2021-11-08 23:49:00,Winnings,Bonus,1.0,150.67,662.01
Draftkings,2021-11-09 00:26:00,Winnings,,36.0,186.67,698.01
Fanduel,2021-11-09 18:47:00,Wager,,-10.0,501.34,688.01
Draftkings,2021-11-09 18:52:00,Wager,,-0.67,186.0,687.34
Draftkings,2021-11-09 19:23:00,Wager,,-10.0,176.0,677.34
Fanduel,2021-11-09 22:30:00,Winnings,Bonus,10.0,511.34,687.34
Fanduel,2021-11-09 23:05:00,Wager,,-10.0,501.34,677.34
Draftkings,2021-11-10 00:11:00,Winnings,,71.42,247.42,748.76
Draftkings,2021-11-10 00:11:00,Winnings,Bonus,1.0,250.42,751.76
Draftkings,2021-11-10 00:11:00,Winnings,Bonus,1.0,249.42,750.76
Draftkings,2021-11-10 00:11:00,Winnings,Bonus,1.0,251.42,752.76
Draftkings,2021-11-10 00:11:00,Winnings,Bonus,1.0,248.42,749.76
Draftkings,2021-11-10 00:17:00,Winnings,,2.01,253.43,754.77
Draftkings,2021-11-10 00:17:00,Winnings,,0.67,254.1,755.44
Draftkings,2021-11-10 17:38:00,Wager,,-10.0,244.1,745.44
Draftkings,2021-11-10 22:19:00,Winnings,,16.06,260.16,761.5
Draftkings,2021-11-10 22:19:00,Winnings,,3.03,263.19,764.53
Draftkings,2021-11-10 22:31:00,Winnings,Bonus,1.0,264.19,765.53
Draftkings,2021-11-11 12:25:00,Wager,,-10.0,254.19,755.53
Fanduel,2021-11-11 22:01:00,Wager,,-5.0,496.34,750.53
Draftkings,2021-11-12 18:30:00,Wager,,-1.19,253.0,749.34
Draftkings,2021-11-12 20:03:00,Wager,,-2.0,251.0,747.34
Fanduel,2021-11-12 22:19:00,Wager,,-0.34,496.0,747.0
Draftkings,2021-11-12 22:38:00,Winnings,Bonus,1.0,252.0,748.0
Fanduel,2021-11-12 22:51:00,Winnings,,2.89,498.89,750.89
Draftkings,2021-11-13 12:24:00,Wager,,-10.0,242.0,740.89
Draftkings,2021-11-13 12:26:00,Wager,,-2.0,240.0,738.89
Fanduel,2021-11-13 12:37:00,Wager,,-20.0,478.89,718.89
Fanduel,2021-11-13 17:25:00,Wager,,-5.0,473.89,713.89
Draftkings,2021-11-13 19:04:00,Winnings,Bonus,1.0,241.0,714.89
Fanduel,2021-11-13 19:04:00,Winnings,,9.63,483.52,724.52
Draftkings,2021-11-14 10:47:00,Wager,,-2.0,239.0,722.52
Draftkings,2021-11-14 12:50:00,Wager,,-5.0,234.0,717.52
Draftkings,2021-11-14 13:35:00,Winnings,,2.15,244.0,727.52
Draftkings,2021-11-14 13:35:00,Winnings,,7.85,241.85,725.37
Fanduel,2021-11-14 15:32:00,Wager,,-35.0,448.52,690.37
Fanduel,2021-11-14 15:50:00,Wager,,-100.0,348.52,590.37
Fanduel,2021-11-14 16:02:00,Winnings,,102.22,515.4,757.25
Fanduel,2021-11-14 16:02:00,Winnings,,64.66,413.18,655.03
Draftkings,2021-11-14 16:06:00,Winnings,Bonus,1.0,248.0,661.18
Fanduel,2021-11-14 16:06:00,Winnings,Bonus,10.0,525.4,773.4
Draftkings,2021-11-14 16:06:00,Winnings,Bonus,1.0,247.0,772.4
Draftkings,2021-11-14 16:06:00,Winnings,Bonus,1.0,246.0,771.4
Draftkings,2021-11-14 16:06:00,Winnings,Bonus,1.0,245.0,770.4
Fanduel,2021-11-14 16:18:00,Wager,,-10.0,515.4,760.4
Draftkings,2021-11-14 17:03:00,Wager,,-10.0,238.0,753.4
Draftkings,2021-11-14 17:15:00,Winnings,Bonus,1.0,239.0,754.4
Draftkings,2021-11-14 19:22:00,Winnings,Bonus,1.0,240.0,755.4
Fanduel,2021-11-14 19:26:00,Winnings,Bonus,10.0,525.4,765.4
Draftkings,2021-11-14 19:43:00,Wager,,-5.0,235.0,760.4
Draftkings,2021-11-14 19:48:00,Wager,,-1.0,234.0,759.4
Fanduel,2021-11-15 13:44:00,Winnings,Bonus,5.0,530.4,764.4
Draftkings,2021-11-15 15:53:00,Wager,,-14.0,220.0,750.4
Draftkings,2021-11-15 23:10:00,Winnings,Bonus,1.0,221.0,751.4
Fanduel,2021-11-16 19:56:00,Wager,,-10.0,520.4,741.4
Draftkings,2021-11-16 19:58:00,Wager,,-1.0,220.0,740.4
Fanduel,2021-11-17 00:17:00,Winnings,Bonus,10.0,530.4,750.4
Draftkings,2021-11-17 16:23:00,Wager,,-5.0,215.0,745.4
Draftkings,2021-11-18 23:43:00,Wager,,-5.0,210.0,740.4
Fanduel,2021-11-21 10:53:00,Wager,,-20.0,510.4,720.4
Fanduel,2021-11-21 11:37:00,Wager,,-10.0,500.4,710.4
Fanduel,2021-11-21 15:03:00,Wager,,-25.0,475.4,685.4
Fanduel,2021-11-21 16:02:00,Winnings,,36.36,511.76,721.76
Fanduel,2021-11-21 16:04:00,Winnings,Bonus,10.0,521.76,731.76
Fanduel,2021-11-21 16:18:00,Wager,,-10.0,511.76,721.76
Fanduel,2021-11-21 19:28:00,Winnings,Bonus,10.0,521.76,731.76
Fanduel,2021-11-24 00:32:00,Wager,,-10.0,511.76,721.76
Fanduel,2021-11-24 00:34:00,Wager,,-10.0,501.76,711.76
Fanduel,2021-11-24 21:07:00,Wager,,-5.0,496.76,706.76
Fanduel,2021-11-25 11:23:00,Wager,,-3.0,493.76,703.76
Fanduel,2021-11-25 14:13:00,Wager,,-7.0,486.76,696.76
Fanduel,2021-11-25 15:41:00,Winnings,,13.6,500.36,710.36
Fanduel,2021-11-25 18:20:00,Wager,,-15.0,485.36,695.36
Fanduel,2021-11-25 23:14:00,Winnings,,30.0,515.36,725.36
Fanduel,2021-11-26 11:30:00,Winnings,Bonus,5.0,520.36,730.36
Fanduel,2021-11-27 11:21:00,Wager,,-5.0,515.36,725.36
Fanduel,2021-11-27 11:29:00,Winnings,,5.0,520.36,730.36
Fanduel,2021-11-27 11:29:00,Wager,,-5.0,515.36,725.36
Fanduel,2021-11-28 19:55:00,Wager,,-5.0,510.36,720.36
Draftkings,2021-11-28 20:17:00,Wager,,-10.0,200.0,710.36
Fanduel,2021-11-28 22:43:00,Wager,,-15.0,495.36,695.36
Draftkings,2021-11-29 00:13:00,Winnings,Bonus,1.0,201.0,696.36
Draftkings,2021-11-29 14:01:00,Wager,,-10.0,191.0,686.36
Draftkings,2021-11-29 14:02:00,Wager,,-1.0,190.0,685.36
Fanduel,2021-11-30 08:57:00,Wager,,-10.0,485.36,675.36
Fanduel,2021-11-30 10:23:00,Winnings,,10.0,495.36,685.36
Draftkings,2021-11-30 10:26:00,Wager,,-2.0,188.0,683.36
Fanduel,2021-11-30 13:12:00,Winnings,Bonus,10.0,505.36,693.36
Fanduel,2021-11-30 18:19:00,Wager,,-10.0,495.36,683.36
Draftkings,2021-11-30 18:39:00,Wager,,-12.0,176.0,671.36
Draftkings,2021-11-30 18:41:00,Wager,,-6.0,170.0,665.36
Draftkings,2021-11-30 21:29:00,Winnings,,9.52,179.52,674.88
Draftkings,2021-11-30 21:32:00,Winnings,Bonus,1.0,180.52,675.88
Fanduel,2021-11-30 22:04:00,Wager,,-10.0,485.36,665.88
Fanduel,2021-11-30 22:04:00,Wager,,-5.0,480.36,660.88
Draftkings,2021-11-30 23:45:00,Winnings,,13.29,193.81,674.17
Draftkings,2021-11-30 23:46:00,Winnings,,3.73,197.54,677.9
Draftkings,2021-12-01 00:20:00,Winnings,,17.45,214.99,695.35
Draftkings,2021-12-01 00:20:00,Winnings,,2.73,217.72,698.08
Draftkings,2021-12-01 00:21:00,Winnings,,11.45,229.17,709.53
Draftkings,2021-12-01 00:21:00,Winnings,,1.36,230.53,710.89
Draftkings,2021-12-01 00:23:00,Winnings,Bonus,1.0,231.53,711.89
Fanduel,2021-12-01 00:23:00,Winnings,Bonus,10.0,490.36,721.89
Draftkings,2021-12-01 18:29:00,Wager,,-10.0,221.53,711.89
Draftkings,2021-12-01 21:19:00,Winnings,,5.5,248.03,738.39
Draftkings,2021-12-01 21:19:00,Winnings,,21.0,242.53,732.89
Draftkings,2021-12-02 19:58:00,Wager,,-10.0,238.03,728.39
Fanduel,2021-12-02 20:02:00,Wager,,-10.0,480.36,718.39
Fanduel,2021-12-02 20:02:00,Wager,,-25.0,455.36,693.39
Fanduel,2021-12-02 23:36:00,Winnings,,70.0,525.36,763.39
Draftkings,2021-12-03 15:44:00,Wager,,-50.0,188.03,713.39
Fanduel,2021-12-03 15:48:00,Wager,,-10.0,515.36,703.39
Fanduel,2021-12-03 23:32:00,Winnings,,19.09,534.45,722.48
Draftkings,2021-12-03 23:39:00,Winnings,Bonus,1.0,190.03,724.48
Draftkings,2021-12-03 23:39:00,Winnings,Bonus,1.0,189.03,723.48
Draftkings,2021-12-04 12:02:00,Wager,,-13.0,177.03,711.48
Draftkings,2021-12-04 12:03:00,Wager,,-2.03,175.0,709.45
Draftkings,2021-12-04 12:07:00,Wager,,-10.0,165.0,699.45
Draftkings,2021-12-04 19:03:00,Winnings,Bonus,1.0,166.0,700.45
Fanduel,2021-12-05 02:37:00,Wager,,-20.0,514.45,680.45
Fanduel,2021-12-05 02:42:00,Wager,,-15.0,499.45,665.45
Fanduel,2021-12-05 10:07:00,Wager,,-5.0,494.45,660.45
Fanduel,2021-12-05 13:31:00,Wager,,-10.0,484.45,650.45
Draftkings,2021-12-05 14:43:00,Wager,,-0.5,165.5,649.95
Draftkings,2021-12-05 15:58:00,Winnings,Bonus,1.0,166.5,650.95
Fanduel,2021-12-05 16:08:00,Winnings,,22.0,506.45,672.95
Fanduel,2021-12-05 18:51:00,Wager,,-8.0,498.45,664.95
Fanduel,2021-12-05 19:07:00,Winnings,Bonus,10.0,526.05,692.55
Fanduel,2021-12-05 19:07:00,Winnings,,17.6,516.05,682.55
Draftkings,2021-12-05 19:37:00,Winnings,Bonus,1.0,167.5,683.55
Fanduel,2021-12-05 20:18:00,Wager,,-5.0,521.05,688.55
Draftkings,2021-12-05 21:07:00,Wager,,-1.5,166.0,687.05
Draftkings,2021-12-05 23:16:00,Winnings,,21.81,187.81,708.86
Draftkings,2021-12-05 23:16:00,Winnings,Bonus,1.0,197.5,718.55
Draftkings,2021-12-05 23:16:00,Winnings,,8.69,196.5,717.55
Fanduel,2021-12-06 18:55:00,Wager,,-10.0,511.05,707.55
Fanduel,2021-12-06 18:56:00,Wager,,-5.0,506.05,702.55
Draftkings,2021-12-06 19:01:00,Wager,,-5.0,192.5,698.55
Fanduel,2021-12-06 19:07:00,Wager,,-5.0,501.05,693.55
Draftkings,2021-12-06 19:18:00,Wager,,-2.0,190.5,691.55
Draftkings,2021-12-06 20:40:00,Winnings,,0.99,196.49,697.54
Draftkings,2021-12-06 20:40:00,Winnings,,5.0,195.5,696.55
Draftkings,2021-12-06 21:22:00,Winnings,Bonus,1.0,197.49,698.54
Fanduel,2021-12-06 23:10:00,Winnings,Bonus,10.0,511.05,708.54
Fanduel,2021-12-06 23:16:00,Winnings,,9.55,520.6,718.09
Fanduel,2021-12-06 23:21:00,Winnings,,16.0,536.6,734.09
Fanduel,2021-12-07 18:42:00,Wager,,-10.0,526.6,724.09
Fanduel,2021-12-07 18:49:00,Wager,,-3.0,523.6,721.09
Draftkings,2021-12-07 18:49:00,Wager,,-12.0,185.49,709.09
Draftkings,2021-12-07 21:55:00,Winnings,,22.43,207.92,731.52
Draftkings,2021-12-07 21:56:00,Winnings,,5.22,213.14,736.74
Fanduel,2021-12-07 23:00:00,Wager,,-2.0,521.6,734.74
Fanduel,2021-12-08 00:29:00,Winnings,Bonus,10.0,531.6,744.74
Draftkings,2021-12-08 17:27:00,Wager,,-1.14,212.0,743.6
Draftkings,2021-12-08 19:19:00,Wager,,-1.0,211.0,742.6
Fanduel,2021-12-09 08:54:00,Wager,,-15.0,516.6,727.6
Fanduel,2021-12-09 08:56:00,Wager,,-2.0,514.6,725.6
Draftkings,2021-12-09 14:23:00,Wager,,-9.0,202.0,716.6
Draftkings,2021-12-09 20:28:00,Winnings,,13.28,215.28,729.88
Draftkings,2021-12-09 20:29:00,Winnings,,3.91,219.19,733.79
Draftkings,2021-12-09 22:40:00,Winnings,Bonus,1.0,220.19,734.79
Fanduel,2021-12-10 22:07:00,Wager,,-1.0,513.6,733.79
Fanduel,2021-12-10 22:19:00,Winnings,,7.5,521.1,741.29
Fanduel,2021-12-11 19:42:00,Wager,,-10.0,511.1,731.29
Fanduel,2021-12-11 19:48:00,Wager,,-10.0,501.1,721.29
Fanduel,2021-12-11 20:01:00,Wager,,-5.0,496.1,716.29
Fanduel,2021-12-12 01:02:00,Wager,,-5.0,491.1,711.29
Fanduel,2021-12-12 01:05:00,Wager,,-5.0,486.1,706.29
Draftkings,2021-12-12 12:52:00,Wager,,-1.0,219.19,705.29
Draftkings,2021-12-12 12:56:00,Wager,,-7.0,212.19,698.29
Fanduel,2021-12-12 15:18:00,Wager,,-2.0,484.1,696.29
Fanduel,2021-12-12 16:35:00,Winnings,,2.87,486.97,699.16
Fanduel,2021-12-12 21:57:00,Winnings,,20.0,506.97,719.16
Fanduel,2021-12-12 22:07:00,Wager,,-5.0,501.97,714.16
Fanduel,2021-12-13 13:16:00,Wager,,-5.0,496.97,709.16
Fanduel,2021-12-13 23:18:00,Winnings,Bonus,10.0,506.97,719.16
Draftkings,2021-12-14 14:47:00,Wager,,-12.19,200.0,706.97
Fanduel,2021-12-14 14:50:00,Wager,,-3.0,503.97,703.97
Fanduel,2021-12-14 14:56:00,Wager,,-10.0,493.97,693.97
Fanduel,2021-12-14 14:58:00,Wager,,-3.0,490.97,690.97
Fanduel,2021-12-14 19:42:00,Winnings,,7.5,498.47,698.47
Fanduel,2021-12-14 21:58:00,Winnings,Bonus,10.0,508.47,708.47
Draftkings,2021-12-15 00:44:00,Winnings,,23.27,223.27,731.74
Draftkings,2021-12-15 00:44:00,Winnings,,5.54,228.81,737.28
Draftkings,2021-12-15 00:46:00,Winnings,Bonus,1.0,229.81,738.28
Fanduel,2021-12-15 20:57:00,Wager,,-5.0,503.47,733.28
Fanduel,2021-12-15 22:12:00,Winnings,,7.27,510.74,740.55
Draftkings,2021-12-16 10:56:00,Wager,,-17.0,212.81,723.55
Fanduel,2021-12-16 11:24:00,Wager,,-3.0,507.74,720.55
Fanduel,2021-12-16 19:55:00,Wager,,-1.0,506.74,719.55
Fanduel,2021-12-16 20:19:00,Wager,,-0.5,506.24,719.05
Fanduel,2021-12-17 22:10:00,Wager,,-20.0,486.24,699.05
Fanduel,2021-12-17 22:12:00,Winnings,,20.0,506.24,719.05
Fanduel,2021-12-17 22:16:00,Wager,,-20.0,486.24,699.05
Fanduel,2021-12-19 00:04:00,Wager,,-4.5,481.74,694.55
Fanduel,2021-12-19 10:18:00,Wager,,-5.0,476.74,689.55
Fanduel,2021-12-19 10:26:00,Wager,,-5.0,471.74,684.55
Fanduel,2021-12-19 13:10:00,Wager,,-5.0,466.74,679.55
Fanduel,2021-12-20 11:59:00,Winnings,Bonus,5.0,471.74,684.55
Fanduel,2021-12-20 12:39:00,Wager,,-8.0,458.74,671.55
Fanduel,2021-12-20 12:39:00,Wager,,-5.0,466.74,679.55
Fanduel,2021-12-20 15:51:00,Wager,,-5.0,453.74,666.55
Fanduel,2021-12-20 20:04:00,Winnings,,113.84,567.58,780.39
Fanduel,2021-12-20 20:04:00,Winnings,Bonus,10.0,577.58,790.39
Fanduel,2021-12-20 23:15:00,Wager,,-1.0,576.58,789.39
Draftkings,2021-12-20 23:21:00,Winnings,Bonus,1.0,213.81,790.39
Fanduel,2021-12-20 23:24:00,Winnings,,5.8,582.38,796.19
Fanduel,2021-12-21 16:16:00,Wager,,-5.0,577.38,791.19
Fanduel,2021-12-21 16:21:00,Wager,,-5.0,572.38,786.19
Fanduel,2021-12-21 16:22:00,Wager,,-1.0,567.38,781.19
Fanduel,2021-12-21 16:22:00,Wager,,-4.0,568.38,782.19
Fanduel,2021-12-21 16:31:00,Wager,,-10.0,557.38,771.19
Fanduel,2021-12-21 20:22:00,Wager,,-3.0,554.38,768.19
Fanduel,2021-12-21 21:47:00,Winnings,Bonus,10.0,564.38,778.19
Fanduel,2021-12-21 21:58:00,Winnings,Bonus,10.0,574.38,788.19
Fanduel,2021-12-21 22:12:00,Winnings,,5.61,579.99,793.8
Fanduel,2021-12-22 11:06:00,Wager,,-10.0,569.99,783.8
Fanduel,2021-12-22 21:05:00,Wager,,-3.0,566.99,780.8
Fanduel,2021-12-22 21:48:00,Wager,,-7.0,559.99,773.8
Fanduel,2021-12-22 22:47:00,Wager,,-5.0,554.99,768.8
Fanduel,2021-12-22 23:08:00,Winnings,Bonus,10.0,580.9,794.71
Fanduel,2021-12-22 23:08:00,Winnings,,9.55,570.9,784.71
Fanduel,2021-12-22 23:08:00,Winnings,,17.08,597.98,811.79
Fanduel,2021-12-22 23:08:00,Winnings,,6.36,561.35,775.16
Fanduel,2021-12-23 19:37:00,Wager,,-10.0,587.98,801.79
Fanduel,2021-12-23 19:40:00,Wager,,-10.0,577.98,791.79
Fanduel,2021-12-23 19:47:00,Wager,,-5.0,572.98,786.79
Fanduel,2021-12-23 21:39:00,Wager,,-2.0,570.98,784.79
Fanduel,2021-12-23 23:14:00,Winnings,Bonus,10.0,580.98,794.79
Fanduel,2021-12-23 23:19:00,Winnings,,3.67,584.65,798.46
Fanduel,2021-12-24 11:27:00,Wager,,-5.0,579.65,793.46
Fanduel,2021-12-24 11:30:00,Wager,,-5.0,574.65,788.46
Fanduel,2021-12-24 11:32:00,Wager,,-5.0,569.65,783.46
Fanduel,2021-12-24 11:33:00,Wager,,-5.0,564.65,778.46
Fanduel,2021-12-24 12:11:00,Wager,,-10.0,554.65,768.46
Fanduel,2021-12-25 19:35:00,Winnings,,26.84,581.49,795.3
Fanduel,2021-12-26 11:23:00,Winnings,Bonus,10.0,591.49,805.3
Fanduel,2021-12-26 16:18:00,Winnings,Bonus,10.0,601.49,815.3
Fanduel,2021-12-27 11:13:00,Winnings,Bonus,5.0,606.49,820.3
Fanduel,2021-12-31 13:06:00,Wager,,-5.0,601.49,815.3
Fanduel,2021-12-31 13:20:00,Wager,,-5.0,596.49,810.3
Fanduel,2021-12-31 13:34:00,Wager,,-5.0,591.49,805.3
Fanduel,2021-12-31 13:39:00,Wager,,-5.0,586.49,800.3
Fanduel,2021-12-31 13:42:00,Wager,,-5.0,581.49,795.3
Fanduel,2021-12-31 13:44:00,Wager,,-1.0,580.49,794.3
Fanduel,2021-12-31 13:47:00,Wager,,-14.0,566.49,780.3
Fanduel,2021-12-31 13:48:00,Wager,,-1.0,565.49,779.3
Fanduel,2021-12-31 19:29:00,Wager,,-2.0,563.49,777.3
Fanduel,2021-12-31 22:12:00,Winnings,,3.7,567.19,781.0
Fanduel,2022-01-01 16:51:00,Wager,,-2.0,565.19,779.0
Fanduel,2022-01-01 21:05:00,Wager,,-8.0,557.19,771.0
Fanduel,2022-01-01 21:47:00,Wager,,-2.0,555.19,769.0
Fanduel,2022-01-02 00:26:00,Winnings,,37.5,592.69,806.5
Fanduel,2022-01-02 00:57:00,Wager,,-5.0,587.69,801.5
Fanduel,2022-01-02 01:05:00,Wager,,-5.0,582.69,796.5
Fanduel,2022-01-02 01:14:00,Wager,,-5.0,577.69,791.5
Fanduel,2022-01-02 01:21:00,Wager,,-5.0,572.69,786.5
Fanduel,2022-01-02 01:24:00,Wager,,-10.0,562.69,776.5
Fanduel,2022-01-02 12:52:00,Winnings,Bonus,10.0,572.69,786.5
Fanduel,2022-01-02 15:40:00,Wager,,-5.0,567.69,781.5
Fanduel,2022-01-02 16:10:00,Winnings,,25.26,592.95,806.76
Fanduel,2022-01-02 16:11:00,Winnings,Bonus,10.0,602.95,816.76
Fanduel,2022-01-02 16:23:00,Wager,,-2.95,600.0,813.81
Fanduel,2022-01-02 19:32:00,Winnings,,14.07,614.07,827.88
Fanduel,2022-01-02 19:47:00,Winnings,,19.09,633.16,846.97
Fanduel,2022-01-02 19:59:00,Wager,,-7.05,626.11,839.92
Fanduel,2022-01-03 11:26:00,Winnings,Bonus,5.0,631.11,844.92
Fanduel,2022-01-07 17:33:00,Wager,,-25.0,606.11,819.92
Fanduel,2022-01-08 08:57:00,Wager,,-2.0,604.11,817.92
Fanduel,2022-01-08 10:22:00,Winnings,Bonus,22.0,626.11,839.92
Fanduel,2022-01-09 09:40:00,Wager,,-5.0,621.11,834.92
Fanduel,2022-01-09 09:47:00,Wager,,-5.0,616.11,829.92
Fanduel,2022-01-09 09:52:00,Wager,,-5.0,611.11,824.92
Fanduel,2022-01-09 09:58:00,Wager,,-5.0,606.11,819.92
Draftkings,2022-01-09 10:04:00,Wager,,-7.0,206.81,812.92
Fanduel,2022-01-09 10:05:00,Wager,,-25.0,581.11,787.92
Fanduel,2022-01-09 12:05:00,Wager,,-1.0,580.11,786.92
Fanduel,2022-01-09 13:53:00,Wager,,-4.0,576.11,782.92
Fanduel,2022-01-09 13:53:00,Wager,,-4.0,572.11,778.92
Fanduel,2022-01-09 16:13:00,Winnings,,14.78,586.89,793.7
Draftkings,2022-01-09 18:58:00,Winnings,Bonus,1.0,207.81,794.7
Fanduel,2022-01-09 19:36:00,Winnings,Bonus,10.0,596.89,804.7
Fanduel,2022-01-09 21:04:00,Wager,,-5.0,591.89,799.7
Fanduel,2022-01-09 21:05:00,Wager,,-2.0,589.89,797.7
Draftkings,2022-01-09 23:58:00,Wager,,-10.0,197.81,787.7
Draftkings,2022-01-10 00:05:00,Winnings,,23.5,221.31,811.2
Draftkings,2022-01-10 17:46:00,Wager,,-10.0,211.31,801.2
Draftkings,2022-01-10 23:58:00,Winnings,,28.0,239.31,829.2
Draftkings,2022-01-11 00:00:00,Winnings,,4.5,243.81,833.7
Draftkings,2022-01-11 00:01:00,Winnings,Bonus,1.0,244.81,834.7
Draftkings,2022-01-12 17:14:00,Wager,,-5.0,234.81,824.7
Draftkings,2022-01-12 17:14:00,Wager,,-5.0,239.81,829.7
Draftkings,2022-01-12 17:17:00,Wager,,-5.0,229.81,819.7
Fanduel,2022-01-12 17:20:00,Wager,,-3.0,586.89,816.7
Draftkings,2022-01-12 20:54:00,Winnings,,1.25,241.06,827.95
Draftkings,2022-01-12 20:54:00,Winnings,,10.0,239.81,826.7
Draftkings,2022-01-12 20:59:00,Winnings,,9.54,250.6,837.49
Draftkings,2022-01-12 21:00:00,Winnings,,1.14,251.74,838.63
Draftkings,2022-01-12 21:06:00,Winnings,,12.25,263.99,850.88
Draftkings,2022-01-12 21:06:00,Winnings,,1.81,265.8,852.69
Fanduel,2022-01-12 21:41:00,Winnings,,8.4,595.29,861.09
Fanduel,2022-01-13 11:58:00,Wager,,-10.0,585.29,851.09
Draftkings,2022-01-13 12:08:00,Wager,,-25.0,240.8,826.09
Fanduel,2022-01-13 21:47:00,Winnings,Bonus,10.0,595.29,836.09
Draftkings,2022-01-13 23:24:00,Winnings,,37.5,278.3,873.59
Draftkings,2022-01-14 00:20:00,Wager,,-25.34,252.96,848.25
Fanduel,2022-01-14 17:18:00,Wager,,-25.0,570.29,823.25
Fanduel,2022-01-14 17:30:00,Wager,,-3.0,567.29,820.25
Draftkings,2022-01-14 21:03:00,Wager,,-2.0,250.96,818.25
Fanduel,2022-01-15 11:28:00,Wager,,-5.0,562.29,813.25
Fanduel,2022-01-15 11:29:00,Wager,,-3.0,559.29,810.25
Fanduel,2022-01-15 11:35:00,Wager,,-10.0,549.29,800.25
Fanduel,2022-01-15 11:42:00,Wager,,-10.0,539.29,790.25
Fanduel,2022-01-15 11:49:00,Wager,,-10.0,529.29,780.25
Draftkings,2022-01-15 11:58:00,Wager,,-10.0,240.96,770.25
Fanduel,2022-01-15 16:00:00,Winnings,Bonus,25.0,554.29,795.25
Draftkings,2022-01-15 19:05:00,Wager,,-12.0,228.96,783.25
Draftkings,2022-01-15 20:35:00,Winnings,,48.37,277.33,831.62
Fanduel,2022-01-16 12:38:00,Wager,,-10.0,544.29,821.62
Fanduel,2022-01-16 12:40:00,Wager,,-4.0,540.29,817.62
Fanduel,2022-01-16 12:41:00,Wager,,-10.0,530.29,807.62
Draftkings,2022-01-16 12:56:00,Wager,,-2.0,275.33,805.62
Draftkings,2022-01-16 16:14:00,Winnings,,12.5,287.83,818.12
Fanduel,2022-01-16 16:16:00,Winnings,,10.05,540.34,828.17
Draftkings,2022-01-16 16:27:00,Wager,,-10.0,277.83,818.17
Draftkings,2022-01-16 16:27:00,Wager,,-2.83,275.0,815.34
Fanduel,2022-01-16 17:37:00,Wager,,-5.0,535.34,810.34
Fanduel,2022-01-16 20:03:00,Winnings,,9.39,544.73,819.73
Draftkings,2022-01-16 20:33:00,Winnings,,0.66,280.66,825.39
Draftkings,2022-01-16 20:33:00,Winnings,,5.0,280.0,824.73
Fanduel,2022-01-16 23:17:00,Winnings,,53.23,597.96,877.96
Draftkings,2022-01-16 23:43:00,Winnings,,10.0,290.66,888.62
Draftkings,2022-01-17 14:44:00,Winnings,,23.8,314.46,912.42
Fanduel,2022-01-17 16:36:00,Wager,,-5.0,592.96,907.42
Draftkings,2022-01-17 16:52:00,Wager,,-10.0,304.46,897.42
Fanduel,2022-01-18 15:55:00,Winnings,Bonus,25.0,617.96,922.42
Draftkings,2022-01-18 19:52:00,Wager,,-8.0,296.46,914.42
Fanduel,2022-01-19 11:25:00,Wager,,-7.0,610.96,907.42
Fanduel,2022-01-19 11:28:00,Wager,,-3.0,607.96,904.42
Fanduel,2022-01-19 11:29:00,Wager,,-15.0,592.96,889.42
Draftkings,2022-01-19 17:40:00,Wager,,-5.0,291.46,884.42
Draftkings,2022-01-19 18:06:00,Wager,,-5.0,286.46,879.42
Fanduel,2022-01-19 22:40:00,Winnings,Bonus,7.0,599.96,886.42
Fanduel,2022-01-19 23:11:00,Winnings,,15.21,615.17,901.63
Fanduel,2022-01-19 23:14:00,Winnings,Bonus,3.0,618.17,904.63
Draftkings,2022-01-20 13:21:00,Wager,,-33.0,253.46,871.63
Draftkings,2022-01-20 16:23:00,Wager,,-10.0,243.46,861.63
Fanduel,2022-01-20 18:55:00,Wager,,-10.0,608.17,851.63
Fanduel,2022-01-20 18:58:00,Wager,,-3.0,605.17,848.63
Fanduel,2022-01-20 21:55:00,Winnings,Bonus,10.0,615.17,858.63
Draftkings,2022-01-20 22:21:00,Wager,,-3.0,237.46,852.63
Draftkings,2022-01-20 22:21:00,Wager,,-3.0,240.46,855.63
Draftkings,2022-01-20 22:22:00,Wager,,-3.0,234.46,849.63
Draftkings,2022-01-21 01:07:00,Winnings,,5.85,240.31,855.48
Draftkings,2022-01-21 01:07:00,Winnings,,0.72,241.03,856.2
Draftkings,2022-01-21 01:07:00,Winnings,,22.51,263.54,878.71
Fanduel,2022-01-21 19:59:00,Wager,,-25.0,590.17,853.71
Fanduel,2022-01-22 12:43:00,Winnings,Bonus,13.0,603.17,866.71
Draftkings,2022-01-22 14:26:00,Wager,,-1.0,262.54,865.71
Draftkings,2022-01-22 14:27:00,Wager,,-3.0,259.54,862.71
Fanduel,2022-01-22 14:35:00,Wager,,-4.0,599.17,858.71
Fanduel,2022-01-22 14:36:00,Wager,,-4.0,595.17,854.71
Draftkings,2022-01-22 19:33:00,Winnings,,20.4,279.94,875.11
Fanduel,2022-01-22 20:03:00,Winnings,,12.8,607.97,887.91
Draftkings,2022-01-22 23:13:00,Winnings,,19.0,298.94,906.91
Draftkings,2022-01-23 10:34:00,Wager,,-7.0,291.94,899.91
Fanduel,2022-01-23 13:59:00,Wager,,-5.0,602.97,894.91
Fanduel,2022-01-23 14:55:00,Wager,,-10.0,592.97,884.91
Fanduel,2022-01-23 14:56:00,Wager,,-2.0,590.97,882.91
Fanduel,2022-01-23 14:56:00,Wager,,-15.0,575.97,867.91
Draftkings,2022-01-23 15:04:00,Wager,,-10.0,281.94,857.91
Draftkings,2022-01-23 15:06:00,Winnings,,26.5,308.44,884.41
Draftkings,2022-01-23 17:19:00,Winnings,,15.53,323.97,899.94
Fanduel,2022-01-23 18:26:00,Winnings,,15.08,591.05,915.02
Draftkings,2022-01-23 18:53:00,Wager,,-8.0,315.97,907.02
Fanduel,2022-01-23 21:29:00,Wager,,-5.0,586.05,902.02
Fanduel,2022-01-23 21:57:00,Winnings,,52.74,638.79,954.76
Fanduel,2022-01-23 21:57:00,Winnings,,12.0,650.79,966.76
Fanduel,2022-01-25 19:27:00,Wager,,-5.0,645.79,961.76
Draftkings,2022-01-25 19:31:00,Wager,,-6.0,309.97,955.76
Draftkings,2022-01-25 19:33:00,Wager,,-4.97,305.0,950.79
Draftkings,2022-01-26 01:03:00,Winnings,,15.34,320.34,966.13
Fanduel,2022-01-26 11:34:00,Wager,,-5.0,640.79,961.13
Fanduel,2022-01-26 11:38:00,Wager,,-5.0,635.79,956.13
Fanduel,2022-01-26 11:43:00,Wager,,-3.0,632.79,953.13
Fanduel,2022-01-26 11:46:00,Wager,,-2.79,630.0,950.34
Draftkings,2022-01-26 17:34:00,Wager,,-8.0,312.34,942.34
Draftkings,2022-01-26 22:10:00,Winnings,,24.35,336.69,966.69
Draftkings,2022-01-27 13:44:00,Wager,,-14.1,322.59,952.59
Draftkings,2022-01-27 19:04:00,Wager,,-6.0,316.59,946.59
Fanduel,2022-01-27 19:23:00,Wager,,-10.0,620.0,936.59
Fanduel,2022-01-27 19:26:00,Wager,,-1.0,619.0,935.59
Draftkings,2022-01-27 23:04:00,Winnings,,3.21,359.43,978.43
Draftkings,2022-01-27 23:04:00,Winnings,,12.72,356.22,975.22
Draftkings,2022-01-27 23:04:00,Winnings,,26.91,343.5,962.5
Fanduel,2022-01-28 00:34:00,Winnings,Bonus,10.0,629.0,972.5
Draftkings,2022-01-28 01:00:00,Winnings,,16.17,375.6,1004.6
Fanduel,2022-01-28 18:42:00,Wager,,-25.0,604.0,979.6
Draftkings,2022-01-28 18:45:00,Wager,,-2.6,373.0,977.0
Draftkings,2022-01-28 18:50:00,Wager,,-8.0,365.0,969.0
Fanduel,2022-01-28 20:18:00,Winnings,,120.0,724.0,1089.0
Fanduel,2022-01-29 10:38:00,Winnings,Bonus,25.0,749.0,1114.0
Draftkings,2022-01-29 11:56:00,Wager,,-5.0,360.0,1109.0
Draftkings,2022-01-29 12:00:00,Wager,,-8.0,352.0,1101.0
Fanduel,2022-01-29 12:02:00,Wager,,-3.0,746.0,1098.0
Draftkings,2022-01-29 18:14:00,Winnings,,21.05,373.05,1119.05
Draftkings,2022-01-29 21:17:00,Wager,,-1.0,372.05,1118.05
Draftkings,2022-01-29 21:20:00,Wager,,-1.0,371.05,1117.05
Draftkings,2022-01-30 10:02:00,Wager,,-10.0,361.05,1107.05
Draftkings,2022-01-30 10:10:00,Wager,,-15.0,346.05,1092.05
Draftkings,2022-01-30 14:38:00,Wager,,-10.0,336.05,1082.05
Fanduel,2022-01-30 14:47:00,Wager,,-10.0,736.0,1072.05
Draftkings,2022-01-30 15:19:00,Winnings,,8.0,344.05,1080.05
Draftkings,2022-01-30 17:15:00,Winnings,,15.4,359.45,1095.45
Draftkings,2022-01-30 17:16:00,Winnings,,4.6,364.05,1100.05
Draftkings,2022-01-30 18:19:00,Winnings,,20.8,384.85,1120.85
Draftkings,2022-01-30 18:38:00,Wager,,-17.0,367.85,1103.85
Draftkings,2022-01-30 18:52:00,Winnings,,36.0,403.85,1139.85
Draftkings,2022-01-30 20:35:00,Wager,,-10.0,393.85,1129.85
Draftkings,2022-01-30 20:42:00,Winnings,,21.0,414.85,1150.85
Fanduel,2022-01-30 21:41:00,Winnings,Bonus,10.0,746.0,1160.85
Draftkings,2022-01-30 22:14:00,Winnings,,50.15,465.0,1211.0
Draftkings,2022-01-31 12:31:00,Wager,,-10.0,455.0,1201.0
Fanduel,2022-01-31 20:13:00,Wager,,-6.0,740.0,1195.0
Fanduel,2022-01-31 20:15:00,Wager,,-10.0,730.0,1185.0
Fanduel,2022-01-31 20:20:00,Wager,,-5.0,725.0,1180.0
Fanduel,2022-01-31 20:52:00,Winnings,,10.01,735.01,1190.01
Fanduel,2022-01-31 21:51:00,Winnings,,5.13,740.14,1195.14
Draftkings,2022-02-01 00:02:00,Winnings,,31.28,486.28,1226.42
Draftkings,2022-02-01 16:37:00,Wager,,-6.28,480.0,1220.14
Draftkings,2022-02-01 16:48:00,Wager,,-5.0,475.0,1215.14
Fanduel,2022-02-01 17:58:00,Wager,,-4.0,736.14,1211.14
Fanduel,2022-02-01 18:01:00,Wager,,-4.0,732.14,1207.14
Fanduel,2022-02-01 18:08:00,Wager,,-4.0,728.14,1203.14
Fanduel,2022-02-01 18:16:00,Wager,,-2.0,726.14,1201.14
Fanduel,2022-02-01 18:17:00,Wager,,-3.0,723.14,1198.14
Draftkings,2022-02-01 21:33:00,Winnings,,13.18,488.18,1211.32
Draftkings,2022-02-01 21:33:00,Winnings,,1.38,489.56,1212.7
Fanduel,2022-02-01 21:35:00,Winnings,,12.85,735.99,1225.55
Fanduel,2022-02-01 22:33:00,Winnings,Bonus,4.0,739.99,1229.55
Fanduel,2022-02-01 22:51:00,Winnings,,21.97,761.96,1251.52
Fanduel,2022-02-01 23:28:00,Winnings,,22.61,784.57,1274.13
Fanduel,2022-02-01 23:33:00,Winnings,,10.5,795.07,1284.63
Fanduel,2022-02-02 18:01:00,Wager,,-5.0,790.07,1279.63
Fanduel,2022-02-02 18:05:00,Wager,,-4.0,786.07,1275.63
Fanduel,2022-02-02 18:09:00,Wager,,-4.0,782.07,1271.63
Fanduel,2022-02-02 18:13:00,Wager,,-4.0,778.07,1267.63
Fanduel,2022-02-02 18:19:00,Wager,,-4.0,774.07,1263.63
Fanduel,2022-02-02 18:25:00,Wager,,-4.0,770.07,1259.63
Draftkings,2022-02-02 18:56:00,Wager,,-5.0,484.56,1254.63
Draftkings,2022-02-02 18:58:00,Wager,,-1.56,483.0,1253.07
Draftkings,2022-02-02 20:45:00,Winnings,,20.98,503.98,1274.05
Draftkings,2022-02-02 21:01:00,Winnings,,3.35,507.33,1277.4
Draftkings,2022-02-02 21:01:00,Winnings,,0.27,507.6,1277.67
Fanduel,2022-02-02 21:20:00,Winnings,,26.38,796.45,1304.05
Fanduel,2022-02-02 21:33:00,Winnings,,12.0,808.45,1316.05
Fanduel,2022-02-02 21:50:00,Winnings,Bonus,4.0,812.45,1320.05
Fanduel,2022-02-02 22:44:00,Wager,,-5.0,807.45,1315.05
Draftkings,2022-02-02 22:47:00,Wager,,-1.0,506.6,1314.05
Fanduel,2022-02-02 23:10:00,Winnings,Bonus,4.0,811.45,1318.05
Fanduel,2022-02-03 00:13:00,Winnings,,6.0,817.45,1324.05
Fanduel,2022-02-03 15:52:00,Wager,,-10.0,807.45,1314.05
Fanduel,2022-02-03 15:53:00,Wager,,-8.0,799.45,1306.05
Fanduel,2022-02-03 18:54:00,Wager,,-20.0,779.45,1286.05
Draftkings,2022-02-03 20:22:00,Wager,,-4.0,502.6,1282.05
Fanduel,2022-02-03 21:55:00,Winnings,Bonus,10.0,789.45,1292.05
Fanduel,2022-02-03 22:05:00,Winnings,Bonus,20.0,809.45,1312.05
Fanduel,2022-02-03 22:51:00,Winnings,,8.1,817.55,1320.15
Draftkings,2022-02-04 00:57:00,Winnings,,17.7,520.3,1337.85
Fanduel,2022-02-04 12:03:00,Wager,,-10.0,807.55,1327.85
Fanduel,2022-02-04 16:53:00,Winnings,,50.44,857.99,1378.29
Draftkings,2022-02-05 09:31:00,Wager,,-5.0,515.3,1373.29
Draftkings,2022-02-05 09:36:00,Wager,,-6.3,509.0,1366.99
Fanduel,2022-02-05 09:57:00,Wager,,-10.0,847.99,1356.99
Fanduel,2022-02-05 10:00:00,Wager,,-3.0,828.99,1337.99
Fanduel,2022-02-05 10:00:00,Winnings,,3.0,831.99,1340.99
Fanduel,2022-02-05 10:00:00,Wager,,-16.0,831.99,1340.99
Fanduel,2022-02-05 10:02:00,Wager,,-3.0,828.99,1337.99
Fanduel,2022-02-05 10:03:00,Wager,,-2.0,826.99,1335.99
Fanduel,2022-02-05 10:04:00,Winnings,,2.0,828.99,1337.99
Fanduel,2022-02-05 10:04:00,Winnings,,16.0,844.99,1353.99
Fanduel,2022-02-05 10:06:00,Wager,,-12.0,832.99,1341.99
Fanduel,2022-02-05 12:08:00,Winnings,,3.0,835.99,1344.99
Fanduel,2022-02-05 12:10:00,Winnings,,12.0,847.99,1356.99
Fanduel,2022-02-05 12:11:00,Wager,,-8.49,839.5,1348.5
Fanduel,2022-02-05 17:08:00,Winnings,,21.23,860.73,1369.73
Draftkings,2022-02-05 18:04:00,Wager,,-20.0,489.0,1349.73
Fanduel,2022-02-05 23:38:00,Winnings,Bonus,10.0,870.73,1359.73
Fanduel,2022-02-06 17:19:00,Wager,,-2.51,868.22,1357.22
Fanduel,2022-02-06 17:49:00,Winnings,,2.52,870.74,1359.74
Draftkings,2022-02-06 20:24:00,Winnings,,14.0,503.0,1373.74
Draftkings,2022-02-06 20:40:00,Winnings,,6.0,509.0,1379.74
Fanduel,2022-02-06 20:42:00,Wager,,-4.0,866.74,1375.74
Draftkings,2022-02-06 23:40:00,Winnings,,41.0,550.0,1416.74
Fanduel,2022-02-06 23:58:00,Winnings,,10.4,877.14,1427.14
Draftkings,2022-02-07 19:12:00,Wager,,-5.0,545.0,1422.14
Fanduel,2022-02-07 19:16:00,Wager,,-5.0,872.14,1417.14
Caesars,2022-02-08 00:04:00,Deposit,,100.0,100.0,1517.14
Caesars,2022-02-08 00:08:00,Wager,,-20.0,80.0,1497.14
Fanduel,2022-02-08 16:29:00,Wager,,-7.0,865.14,1490.14
Caesars,2022-02-08 16:29:00,Wager,,-6.0,74.0,1484.14
Fanduel,2022-02-08 17:50:00,Wager,,-4.0,861.14,1480.14
Fanduel,2022-02-08 17:53:00,Wager,,-4.0,857.14,1476.14
Fanduel,2022-02-08 17:56:00,Wager,,-4.0,853.14,1472.14
Fanduel,2022-02-08 18:00:00,Wager,,-4.0,849.14,1468.14
Fanduel,2022-02-08 18:02:00,Wager,,-2.0,847.14,1466.14
Draftkings,2022-02-08 18:06:00,Wager,,-5.0,540.0,1461.14
Draftkings,2022-02-08 18:18:00,Wager,,-5.0,535.0,1456.14
Fanduel,2022-02-08 19:07:00,Wager,,-2.0,845.14,1454.14
Fanduel,2022-02-08 19:07:00,Wager,,-1.0,844.14,1453.14
Draftkings,2022-02-08 21:21:00,Winnings,,12.75,547.75,1465.89
Draftkings,2022-02-08 21:21:00,Winnings,,1.55,549.3,1467.44
Fanduel,2022-02-08 23:16:00,Winnings,Bonus,4.0,848.14,1471.44
Caesars,2022-02-08 23:20:00,Winnings,,21.0,95.0,1492.44
Caesars,2022-02-09 00:32:00,Winnings,,38.18,133.18,1530.62
Fanduel,2022-02-09 00:50:00,Winnings,Bonus,4.0,852.14,1534.62
Draftkings,2022-02-09 00:57:00,Wager,,-6.3,543.0,1528.32
Caesars,2022-02-09 17:42:00,Wager,,-5.0,128.18,1523.32
Fanduel,2022-02-09 17:48:00,Wager,,-4.0,848.14,1519.32
Fanduel,2022-02-09 17:50:00,Wager,,-4.0,844.14,1515.32
Fanduel,2022-02-09 17:51:00,Wager,,-4.0,840.14,1511.32
Fanduel,2022-02-09 17:53:00,Wager,,-4.0,836.14,1507.32
Fanduel,2022-02-09 22:14:00,Winnings,Bonus,4.0,840.14,1511.32
Caesars,2022-02-10 00:54:00,Winnings,,10.5,138.68,1521.82
Caesars,2022-02-10 16:15:00,Wager,,-25.0,113.68,1496.82
Caesars,2022-02-10 16:16:00,Wager,,-25.0,88.68,1471.82
Fanduel,2022-02-10 16:20:00,Wager,,-10.0,830.14,1461.82
Draftkings,2022-02-10 19:14:00,Wager,,-5.0,538.0,1456.82
Draftkings,2022-02-10 19:34:00,Wager,,-5.0,533.0,1451.82
Fanduel,2022-02-11 00:39:00,Winnings,Bonus,10.0,840.14,1461.82
Caesars,2022-02-11 09:18:00,Wager,,-15.0,73.68,1446.82
Draftkings,2022-02-11 15:59:00,Wager,,-5.0,528.0,1441.82
Draftkings,2022-02-11 18:29:00,Wager,,-20.0,508.0,1421.82
Caesars,2022-02-11 21:18:00,Winnings,,28.64,102.32,1450.46
Caesars,2022-02-12 11:32:00,Wager,,-25.0,102.32,1450.46
Caesars,2022-02-12 11:32:00,Winnings,Bonus,25.0,102.32,1450.46
Draftkings,2022-02-12 17:50:00,Wager,,-20.0,488.0,1430.46
Draftkings,2022-02-12 18:01:00,Wager,,-5.0,483.0,1425.46
Fanduel,2022-02-12 18:07:00,Wager,,-10.0,830.14,1415.46
Fanduel,2022-02-12 23:18:00,Winnings,Bonus,10.0,840.14,1425.46
Draftkings,2022-02-13 11:30:00,Wager,,-4.0,479.0,1421.46
Fanduel,2022-02-13 12:15:00,Wager,,-12.0,828.14,1409.46
Caesars,2022-02-13 12:17:00,Wager,,-50.0,102.32,1409.46
Caesars,2022-02-13 12:17:00,Winnings,Bonus,50.0,102.32,1409.46
Fanduel,2022-02-13 15:00:00,Winnings,,12.57,840.71,1422.03
Fanduel,2022-02-13 16:03:00,Wager,,-20.0,820.71,1402.03
Draftkings,2022-02-13 16:07:00,Wager,,-10.0,469.0,1392.03
Draftkings,2022-02-13 16:09:00,Wager,,-1.0,468.0,1391.03
Caesars,2022-02-13 16:11:00,Winnings,Bonus,50.0,102.32,1391.03
Caesars,2022-02-13 16:11:00,Wager,,-50.0,102.32,1391.03
Draftkings,2022-02-13 18:41:00,Wager,,-10.0,448.0,1371.03
Draftkings,2022-02-13 18:41:00,Wager,,-10.0,458.0,1381.03
Caesars,2022-02-13 18:42:00,Winnings,,50.0,152.32,1431.03
Draftkings,2022-02-13 18:42:00,Wager,,10.0,458.0,1431.03
Draftkings,2022-02-13 18:56:00,Winnings,,10.0,468.0,1441.03
Draftkings,2022-02-13 19:49:00,Winnings,,31.42,499.42,1472.45
Draftkings,2022-02-13 19:51:00,Winnings,,8.58,508.0,1481.03
Caesars,2022-02-13 22:03:00,Winnings,,45.45,197.77,1526.48
Fanduel,2022-02-13 22:06:00,Winnings,,35.0,855.71,1561.48
Fanduel,2022-02-13 22:23:00,Winnings,Bonus,20.0,875.71,1581.48
Caesars,2022-02-14 18:50:00,Wager,,-15.0,197.77,1581.48
Caesars,2022-02-14 18:50:00,Winnings,Bonus,15.0,197.77,1581.48
Caesars,2022-02-14 18:58:00,Wager,,-14.0,183.77,1567.48
Draftkings,2022-02-14 19:04:00,Wager,,-25.0,483.0,1542.48
Draftkings,2022-02-14 19:12:00,Wager,,-25.0,458.0,1517.48
Draftkings,2022-02-14 19:17:00,Wager,,-10.0,448.0,1507.48
Draftkings,2022-02-14 21:33:00,Wager,,-5.0,438.0,1497.48
Draftkings,2022-02-14 21:33:00,Wager,,-5.0,443.0,1502.48
Draftkings,2022-02-14 21:34:00,Wager,,-5.0,433.0,1492.48
Draftkings,2022-02-14 22:38:00,Winnings,,35.5,468.5,1527.98
Caesars,2022-02-14 22:46:00,Winnings,,57.4,241.17,1585.38
Fanduel,2022-02-15 12:00:00,Wager,,-10.0,865.71,1575.38
Fanduel,2022-02-15 12:22:00,Wager,,-10.0,855.71,1565.38
Fanduel,2022-02-15 16:18:00,Winnings,Bonus,10.0,865.71,1575.38
Draftkings,2022-02-15 18:39:00,Wager,,-10.0,458.5,1565.38
Draftkings,2022-02-15 20:26:00,Wager,,-30.0,428.5,1535.38
Caesars,2022-02-15 20:28:00,Wager,,-25.0,216.17,1510.38
Draftkings,2022-02-15 21:52:00,Winnings,,10.25,438.75,1520.63
Draftkings,2022-02-15 21:53:00,Winnings,,1.31,440.06,1521.94
Draftkings,2022-02-15 23:19:00,Winnings,,70.5,510.56,1592.44
Draftkings,2022-02-15 23:19:00,Winnings,,40.5,551.06,1632.94
Fanduel,2022-02-16 17:00:00,Wager,,-15.0,850.71,1617.94
Fanduel,2022-02-16 17:00:00,Wager,,-5.0,860.71,1627.94
Fanduel,2022-02-16 17:00:00,Winnings,,5.0,865.71,1632.94
Fanduel,2022-02-16 17:00:00,Winnings,,15.0,865.71,1632.94
Draftkings,2022-02-16 17:06:00,Wager,,-6.06,545.0,1626.88
Draftkings,2022-02-16 20:20:00,Wager,,-3.0,542.0,1623.88
Draftkings,2022-02-16 23:29:00,Winnings,,21.21,563.21,1645.09
Draftkings,2022-02-16 23:29:00,Winnings,,4.99,568.2,1650.08
Fanduel,2022-02-17 19:06:00,Wager,,-10.0,855.71,1640.08
Fanduel,2022-02-17 19:07:00,Winnings,,10.0,855.71,1640.08
Fanduel,2022-02-17 19:07:00,Wager,,-10.0,845.71,1630.08
Draftkings,2022-02-17 19:12:00,Wager,,-13.2,555.0,1616.88
Caesars,2022-02-17 19:14:00,Wager,,-14.0,216.17,1616.88
Caesars,2022-02-17 19:14:00,Winnings,Bonus,14.0,216.17,1616.88
Draftkings,2022-02-17 19:18:00,Wager,,-5.0,550.0,1611.88
Fanduel,2022-02-17 23:10:00,Winnings,Bonus,10.0,865.71,1631.88
Caesars,2022-02-17 23:36:00,Winnings,,19.6,235.77,1651.48
Caesars,2022-02-18 17:39:00,Wager,,-20.0,215.77,1631.48
Draftkings,2022-02-18 18:05:00,Wager,,-10.0,540.0,1621.48
Draftkings,2022-02-18 18:07:00,Wager,,-5.0,535.0,1616.48
Draftkings,2022-02-18 20:53:00,Wager,,-6.0,529.0,1610.48
Draftkings,2022-02-18 21:52:00,Winnings,,11.21,540.21,1621.69
Draftkings,2022-02-18 21:52:00,Winnings,,1.72,541.93,1623.41
Caesars,2022-02-18 22:37:00,Winnings,,35.38,251.15,1658.79
Caesars,2022-02-19 11:25:00,Wager,,-50.0,201.15,1608.79
Draftkings,2022-02-19 11:32:00,Wager,,-5.0,536.93,1603.79
Caesars,2022-02-19 14:12:00,Winnings,,95.45,296.6,1699.24
Fanduel,2022-02-19 19:07:00,Wager,,-5.0,860.71,1694.24
Fanduel,2022-02-19 19:08:00,Wager,,-5.0,860.71,1694.24
Fanduel,2022-02-19 19:08:00,Winnings,,5.0,865.71,1699.24
Fanduel,2022-02-19 19:10:00,Wager,,-4.0,856.71,1690.24
Caesars,2022-02-20 11:01:00,Winnings,Bonus,20.0,296.6,1690.24
Caesars,2022-02-20 11:01:00,Wager,,-20.0,296.6,1690.24
Draftkings,2022-02-20 11:05:00,Wager,,-6.93,530.0,1683.31
Draftkings,2022-02-20 13:11:00,Wager,,-7.0,523.0,1676.31
Draftkings,2022-02-20 13:17:00,Wager,,-8.0,515.0,1668.31
Draftkings,2022-02-20 18:18:00,Winnings,,14.0,529.0,1682.31
Draftkings,2022-02-20 18:18:00,Winnings,,3.5,532.5,1685.81
Draftkings,2022-02-20 18:45:00,Winnings,,15.59,548.09,1701.4
Draftkings,2022-02-20 18:45:00,Winnings,,1.73,549.82,1703.13
Draftkings,2022-02-20 19:16:00,Winnings,,10.0,559.82,1713.13
Caesars,2022-02-20 20:42:00,Winnings,,28.0,324.6,1741.13
Draftkings,2022-02-21 20:12:00,Wager,,-5.0,554.82,1736.13
Fanduel,2022-02-22 10:02:00,Wager,,-5.0,851.71,1731.13
Fanduel,2022-02-22 10:03:00,Winnings,,5.0,851.71,1731.13
Fanduel,2022-02-22 10:03:00,Wager,,-5.0,846.71,1726.13
Caesars,2022-02-22 10:10:00,Wager,,-25.0,299.6,1701.13
Draftkings,2022-02-22 16:30:00,Wager,,-9.82,545.0,1691.31
Draftkings,2022-02-22 18:56:00,Wager,,-5.0,540.0,1686.31
Draftkings,2022-02-22 20:56:00,Winnings,,19.64,559.64,1705.95
Draftkings,2022-02-22 20:57:00,Winnings,,2.16,561.8,1708.11
Caesars,2022-02-22 20:58:00,Winnings,,47.73,347.33,1755.84
Draftkings,2022-02-22 21:06:00,Winnings,,1.21,573.51,1767.55
Draftkings,2022-02-22 21:06:00,Winnings,,10.5,572.3,1766.34
Fanduel,2022-02-23 09:30:00,Wager,,-3.0,848.71,1768.34
Fanduel,2022-02-23 09:31:00,Wager,,-3.0,845.71,1765.34
Caesars,2022-02-23 18:40:00,Winnings,Bonus,24.0,347.33,1765.34
Caesars,2022-02-23 18:40:00,Wager,,-24.0,347.33,1765.34
Fanduel,2022-02-23 20:50:00,Winnings,,3.3,849.01,1768.64
Caesars,2022-02-23 23:20:00,Winnings,,27.65,374.98,1796.29
Fanduel,2022-02-24 16:18:00,Wager,,-3.0,846.01,1793.29
Fanduel,2022-02-24 16:19:00,Wager,,-3.0,843.01,1790.29
Caesars,2022-02-24 18:37:00,Wager,,-13.0,361.98,1777.29
Caesars,2022-02-24 18:42:00,Wager,,-10.0,351.98,1767.29
Draftkings,2022-02-24 19:11:00,Wager,,-15.0,558.51,1753.5
Fanduel,2022-02-24 20:04:00,Wager,,-1.0,842.01,1752.5
Fanduel,2022-02-24 20:22:00,Winnings,,7.5,849.51,1760.0
Caesars,2022-02-24 21:31:00,Winnings,,10.0,361.98,1770.0
Fanduel,2022-02-24 22:06:00,Winnings,,10.5,860.01,1780.5
Caesars,2022-02-24 22:36:00,Winnings,,31.2,393.18,1811.7
Draftkings,2022-02-24 22:58:00,Winnings,,38.25,596.76,1849.95
Draftkings,2022-02-24 22:58:00,Winnings,,23.25,620.01,1873.2
Fanduel,2022-02-25 16:17:00,Winnings,Bonus,5.0,865.01,1878.2
Caesars,2022-02-25 16:48:00,Winnings,Bonus,50.0,393.18,1878.2
Caesars,2022-02-25 16:48:00,Wager,,-50.0,393.18,1878.2
Fanduel,2022-02-25 16:55:00,Wager,,-2.0,863.01,1876.2
Caesars,2022-02-25 22:15:00,Winnings,,45.45,438.63,1921.65
Draftkings,2022-02-25 22:15:00,Winnings,,6.0,626.01,1927.65
Fanduel,2022-02-25 23:22:00,Winnings,,7.0,870.01,1934.65
Draftkings,2022-02-26 08:51:00,Wager,,-20.0,606.01,1914.65
Draftkings,2022-02-26 08:55:00,Wager,,-5.0,601.01,1909.65
Caesars,2022-02-26 09:37:00,Wager,,-25.0,413.63,1884.65
Caesars,2022-02-26 09:39:00,Wager,,-25.0,388.63,1859.65
Caesars,2022-02-26 09:40:00,Wager,,-13.0,375.63,1846.65
Caesars,2022-02-26 23:24:00,Winnings,,47.73,423.36,1894.38
Fanduel,2022-02-28 17:24:00,Wager,,-10.0,860.01,1884.38
Draftkings,2022-02-28 19:49:00,Wager,,-6.01,595.0,1878.37
Draftkings,2022-02-28 19:57:00,Wager,,-5.0,590.0,1873.37
Caesars,2022-02-28 20:09:00,Wager,,-28.0,423.36,1873.37
Caesars,2022-02-28 20:09:00,Winnings,Bonus,28.0,423.36,1873.37
Draftkings,2022-02-28 22:44:00,Winnings,,32.0,622.0,1905.37
Fanduel,2022-02-28 23:22:00,Winnings,,18.7,878.71,1924.07
Draftkings,2022-03-01 01:05:00,Winnings,,32.02,654.02,1956.09
Caesars,2022-03-01 16:52:00,Wager,,-25.0,423.36,1956.09
Caesars,2022-03-01 16:52:00,Winnings,Bonus,25.0,423.36,1956.09
Draftkings,2022-03-01 17:17:00,Wager,,-12.0,642.02,1944.09
Fanduel,2022-03-01 18:58:00,Wager,,-18.7,860.01,1925.39
Draftkings,2022-03-01 19:09:00,Wager,,-7.02,635.0,1918.37
Fanduel,2022-03-01 22:05:00,Wager,,-0.1,859.91,1918.27
Fanduel,2022-03-01 22:07:00,Wager,,-0.1,859.81,1918.17
Fanduel,2022-03-01 22:26:00,Wager,,-0.81,859.0,1917.36
Fanduel,2022-03-01 22:46:00,Winnings,,35.1,894.1,1952.46
Caesars,2022-03-02 16:57:00,Wager,,-5.0,423.36,1952.46
Caesars,2022-03-02 16:57:00,Winnings,Bonus,5.0,423.36,1952.46
Caesars,2022-03-02 16:59:00,Wager,,-3.0,420.36,1949.46
Draftkings,2022-03-02 17:07:00,Wager,,-13.0,622.0,1936.46
Caesars,2022-03-02 17:43:00,Wager,,-50.0,420.36,1936.46
Caesars,2022-03-02 17:43:00,Winnings,Bonus,50.0,420.36,1936.46
Fanduel,2022-03-02 17:48:00,Wager,,-35.1,859.0,1901.36
Caesars,2022-03-02 22:08:00,Winnings,,45.45,465.81,1946.81
Draftkings,2022-03-02 22:55:00,Winnings,,13.32,674.97,1999.78
Draftkings,2022-03-02 22:55:00,Winnings,,39.65,661.65,1986.46
Fanduel,2022-03-03 18:06:00,Wager,,-25.0,834.0,1961.46
Draftkings,2022-03-03 18:14:00,Wager,,-12.0,662.97,1962.78
Draftkings,2022-03-03 23:03:00,Winnings,,9.72,704.11,2003.92
Draftkings,2022-03-03 23:03:00,Winnings,,31.42,694.39,1994.2
Fanduel,2022-03-04 12:08:00,Winnings,Bonus,25.0,859.0,2019.2
Caesars,2022-03-04 16:40:00,Wager,,-8.0,457.81,2011.2
Fanduel,2022-03-04 17:26:00,Winnings,Bonus,-5.0,854.0,2006.2
Draftkings,2022-03-04 18:59:00,Wager,,-15.0,689.11,2000.92
Draftkings,2022-03-04 22:47:00,Winnings,,14.25,746.86,2058.67
Draftkings,2022-03-04 22:47:00,Winnings,,43.5,732.61,2044.42
Caesars,2022-03-04 23:39:00,Winnings,,17.2,475.01,2061.62
Fanduel,2022-03-05 10:44:00,Wager,,-25.0,829.0,2036.62
Fanduel,2022-03-05 10:48:00,Wager,,-5.0,824.0,2031.62
Fanduel,2022-03-05 10:48:00,Wager,,-4.0,820.0,2027.62
Fanduel,2022-03-05 10:51:00,Wager,,-4.0,816.0,2023.62
Draftkings,2022-03-05 11:15:00,Wager,,-16.86,730.0,2021.01
Caesars,2022-03-05 11:17:00,Wager,,-12.0,463.01,2009.01
Draftkings,2022-03-05 16:09:00,Winnings,,32.91,762.91,2041.92
Draftkings,2022-03-05 16:10:00,Winnings,,8.03,770.94,2049.95
Draftkings,2022-03-05 17:32:00,Wager,,-10.0,760.94,2039.95
Draftkings,2022-03-05 17:36:00,Wager,,-4.0,756.94,2035.95
Draftkings,2022-03-05 17:37:00,Wager,,-3.94,753.0,2032.01
Caesars,2022-03-05 18:10:00,Wager,,-3.01,460.0,2029.0
Fanduel,2022-03-05 18:36:00,Wager,,-3.0,813.0,2026.0
Fanduel,2022-03-05 23:09:00,Winnings,,7.5,820.5,2033.5
Fanduel,2022-03-06 00:15:00,Winnings,,26.38,846.88,2059.88
Fanduel,2022-03-06 01:07:00,Winnings,Bonus,4.0,850.88,2063.88
Draftkings,2022-03-06 10:19:00,Wager,,-5.0,748.0,2058.88
Fanduel,2022-03-06 12:24:00,Winnings,Bonus,16.0,866.88,2074.88
Fanduel,2022-03-06 14:05:00,Wager,,-10.0,856.88,2064.88
Fanduel,2022-03-06 18:07:00,Winnings,Bonus,10.0,866.88,2074.88
Draftkings,2022-03-06 18:32:00,Winnings,,7.0,755.0,2081.88
Fanduel,2022-03-07 09:09:00,Winnings,,7.0,866.88,2081.88
Fanduel,2022-03-07 09:09:00,Wager,,-10.0,856.88,2071.88
Fanduel,2022-03-07 09:09:00,Wager,,-7.0,859.88,2074.88
Fanduel,2022-03-07 09:10:00,Winnings,,10.0,866.88,2081.88
Draftkings,2022-03-07 18:06:00,Wager,,-9.0,746.0,2072.88
Fanduel,2022-03-07 18:45:00,Wager,,-10.0,856.88,2062.88
Fanduel,2022-03-08 11:27:00,Wager,,-10.0,846.88,2052.88
Caesars,2022-03-08 16:26:00,Wager,,-50.0,410.0,2002.88
Draftkings,2022-03-08 16:31:00,Wager,,-8.0,738.0,1994.88
Caesars,2022-03-08 16:37:00,Winnings,Bonus,50.0,410.0,1994.88
Caesars,2022-03-08 16:37:00,Wager,,-50.0,410.0,1994.88
Draftkings,2022-03-08 16:38:00,Wager,,-10.0,728.0,1984.88
Fanduel,2022-03-08 16:58:00,Winnings,Bonus,10.0,856.88,1994.88
Caesars,2022-03-08 21:40:00,Winnings,,91.67,501.67,2086.55
Caesars,2022-03-08 23:13:00,Winnings,,45.45,547.12,2132.0
Caesars,2022-03-09 15:46:00,Wager,,-5.0,547.12,2132.0
Caesars,2022-03-09 15:46:00,Winnings,Bonus,5.0,547.12,2132.0
Caesars,2022-03-09 18:48:00,Wager,,-50.0,547.12,2132.0
Caesars,2022-03-09 18:48:00,Winnings,Bonus,50.0,547.12,2132.0
Draftkings,2022-03-09 18:58:00,Wager,,-8.0,720.0,2124.0
Draftkings,2022-03-09 19:03:00,Wager,,-6.0,714.0,2118.0
Caesars,2022-03-09 21:02:00,Winnings,,45.45,592.57,2163.45
Caesars,2022-03-09 22:18:00,Winnings,,8.67,601.24,2172.12
Draftkings,2022-03-09 22:36:00,Winnings,,14.4,728.4,2186.52
Draftkings,2022-03-09 22:37:00,Winnings,,2.1,730.5,2188.62
Fanduel,2022-03-09 23:43:00,Wager,,-0.88,856.0,2187.74
Fanduel,2022-03-10 00:26:00,Winnings,,1.6,857.6,2189.34
Fanduel,2022-03-10 09:07:00,Wager,,-8.0,849.6,2181.34
Draftkings,2022-03-10 17:59:00,Wager,,-10.0,720.5,2171.34
Draftkings,2022-03-10 18:05:00,Wager,,-10.5,710.0,2160.84
Fanduel,2022-03-10 18:30:00,Wager,,-10.0,839.6,2150.84
Caesars,2022-03-10 20:56:00,Wager,,-50.0,551.24,2100.84
Draftkings,2022-03-10 20:57:00,Wager,,-20.0,690.0,2080.84
Fanduel,2022-03-10 22:08:00,Winnings,Bonus,10.0,849.6,2090.84
Draftkings,2022-03-10 23:41:00,Wager,,-10.0,680.0,2080.84
Fanduel,2022-03-11 16:29:00,Wager,,-6.0,843.6,2074.84
Fanduel,2022-03-11 16:32:00,Wager,,-5.0,838.6,2069.84
Caesars,2022-03-11 16:33:00,Wager,,-25.0,551.24,2069.84
Caesars,2022-03-11 16:33:00,Winnings,Bonus,25.0,551.24,2069.84
Draftkings,2022-03-11 16:41:00,Wager,,-12.0,668.0,2057.84
Draftkings,2022-03-11 16:45:00,Wager,,-7.0,661.0,2050.84
Draftkings,2022-03-11 19:12:00,Wager,,1.0,661.0,2050.84
Draftkings,2022-03-11 19:12:00,Wager,,-1.0,660.0,2049.84
Draftkings,2022-03-11 19:44:00,Wager,,-1.0,660.0,2049.84
Draftkings,2022-03-11 19:47:00,Winnings,,1.95,661.95,2051.79
Draftkings,2022-03-11 23:08:00,Winnings,,20.3,682.25,2072.09
Draftkings,2022-03-11 23:08:00,Winnings,,6.65,688.9,2078.74
Draftkings,2022-03-11 23:26:00,Winnings,,35.4,724.3,2114.14
Draftkings,2022-03-11 23:26:00,Winnings,,11.7,736.0,2125.84
Draftkings,2022-03-12 00:02:00,Wager,,-1.0,735.0,2124.84
Caesars,2022-03-12 12:30:00,Wager,,-3.0,548.24,2121.84
Fanduel,2022-03-12 15:18:00,Wager,,-5.0,833.6,2116.84
Fanduel,2022-03-12 15:20:00,Wager,,-4.0,829.6,2112.84
Fanduel,2022-03-12 15:22:00,Wager,,-5.0,824.6,2107.84
Fanduel,2022-03-12 15:24:00,Wager,,-3.0,821.6,2104.84
Draftkings,2022-03-12 17:24:00,Wager,,-7.0,728.0,2097.84
Fanduel,2022-03-12 17:49:00,Winnings,Bonus,10.0,831.6,2107.84
Fanduel,2022-03-12 19:51:00,Winnings,,27.48,859.08,2135.32
Caesars,2022-03-12 22:17:00,Winnings,Bonus,300.0,548.24,2135.32
Caesars,2022-03-12 22:17:00,Wager,,-300.0,548.24,2135.32
Fanduel,2022-03-13 00:32:00,Winnings,,10.0,859.08,2135.32
Fanduel,2022-03-13 00:32:00,Wager,,-10.0,849.08,2125.32
Fanduel,2022-03-13 00:33:00,Winnings,,8.0,859.08,2135.32
Fanduel,2022-03-13 00:33:00,Winnings,,10.0,859.08,2135.32
Fanduel,2022-03-13 00:33:00,Wager,,-8.0,851.08,2127.32
Fanduel,2022-03-13 00:33:00,Wager,,-10.0,849.08,2125.32
Fanduel,2022-03-13 00:34:00,Winnings,,10.0,859.08,2135.32
Fanduel,2022-03-13 00:34:00,Wager,,-10.0,849.08,2125.32
Caesars,2022-03-13 12:03:00,Wager,,-20.0,528.24,2105.32
Fanduel,2022-03-13 12:57:00,Wager,,-10.0,849.08,2105.32
Draftkings,2022-03-13 13:03:00,Wager,,-4.0,724.0,2101.32
Caesars,2022-03-13 13:24:00,Wager,,-50.0,528.24,2101.32
Caesars,2022-03-13 13:24:00,Winnings,Bonus,50.0,528.24,2101.32
Caesars,2022-03-13 13:50:00,Winnings,,100.0,628.24,2201.32
Caesars,2022-03-13 14:31:00,Wager,,-100.0,528.24,2101.32
Caesars,2022-03-13 17:37:00,Winnings,,190.91,719.15,2292.23
Draftkings,2022-03-13 17:41:00,Wager,,-7.0,717.0,2285.23
Fanduel,2022-03-13 18:02:00,Winnings,Bonus,10.0,859.08,2295.23
Caesars,2022-03-13 23:26:00,Winnings,,55.11,774.26,2350.34
Fanduel,2022-03-17 19:13:00,Wager,,-4.0,855.08,2346.34
Fanduel,2022-03-17 19:21:00,Wager,,-7.0,848.08,2339.34
Fanduel,2022-03-17 19:24:00,Wager,,-3.0,845.08,2336.34
Fanduel,2022-03-17 19:27:00,Wager,,-5.0,840.08,2331.34
Fanduel,2022-03-17 19:29:00,Wager,,-4.0,836.08,2327.34
Draftkings,2022-03-17 20:12:00,Wager,,-11.0,706.0,2316.34
Caesars,2022-03-17 20:28:00,Wager,,-100.0,774.26,2316.34
Caesars,2022-03-17 20:28:00,Winnings,Bonus,100.0,774.26,2316.34
Caesars,2022-03-17 20:37:00,Wager,,-100.0,674.26,2216.34
Fanduel,2022-03-17 22:32:00,Winnings,,36.55,872.63,2252.89
Fanduel,2022-03-18 00:45:00,Winnings,Bonus,3.0,875.63,2255.89
Fanduel,2022-03-18 00:50:00,Winnings,,25.16,900.79,2281.05
Fanduel,2022-03-18 12:43:00,Wager,,-6.0,894.79,2275.05
Fanduel,2022-03-18 12:46:00,Wager,,-6.0,888.79,2269.05
Fanduel,2022-03-18 12:48:00,Wager,,-1.0,887.79,2268.05
Fanduel,2022-03-18 12:50:00,Wager,,-6.0,881.79,2262.05
Caesars,2022-03-18 14:27:00,Winnings,,190.91,865.17,2452.96
Fanduel,2022-03-18 15:01:00,Wager,,-17.12,864.67,2435.84
Fanduel,2022-03-18 16:06:00,Winnings,,17.14,881.81,2452.98
Fanduel,2022-03-18 17:23:00,Wager,,-5.0,876.81,2447.98
Fanduel,2022-03-18 17:31:00,Wager,,-6.0,870.81,2441.98
Fanduel,2022-03-18 17:45:00,Wager,,-3.81,867.0,2438.17
Draftkings,2022-03-18 17:52:00,Wager,,-6.0,700.0,2432.17
Fanduel,2022-03-18 18:29:00,Winnings,,31.4,898.4,2463.57
Fanduel,2022-03-18 21:28:00,Winnings,Bonus,6.0,904.4,2469.57
Fanduel,2022-03-18 21:42:00,Wager,,-6.0,898.4,2463.57
Draftkings,2022-03-18 21:47:00,Wager,,-2.0,698.0,2461.57
Fanduel,2022-03-18 22:09:00,Winnings,,9.53,907.93,2471.1
Fanduel,2022-03-19 00:47:00,Winnings,Bonus,6.0,913.93,2477.1
Fanduel,2022-03-19 08:12:00,Wager,,-8.0,905.93,2469.1
Fanduel,2022-03-19 08:14:00,Wager,,-8.0,897.93,2461.1
Fanduel,2022-03-19 08:21:00,Wager,,-8.0,889.93,2453.1
Draftkings,2022-03-19 08:24:00,Wager,,-7.0,691.0,2446.1
Draftkings,2022-03-19 08:26:00,Wager,,-7.0,684.0,2439.1
Fanduel,2022-03-19 12:38:00,Wager,,-6.0,883.93,2433.1
Fanduel,2022-03-19 12:57:00,Winnings,,6.43,890.36,2439.53
Fanduel,2022-03-19 19:56:00,Winnings,Bonus,8.0,898.36,2447.53
Fanduel,2022-03-19 22:53:00,Winnings,,42.08,940.44,2489.61
Fanduel,2022-03-19 22:57:00,Wager,,-4.0,936.44,2485.61
Fanduel,2022-03-20 11:53:00,Wager,,-8.0,928.44,2477.61
Fanduel,2022-03-20 11:56:00,Wager,,-8.0,920.44,2469.61
Fanduel,2022-03-20 12:00:00,Wager,,-8.0,912.44,2461.61
Draftkings,2022-03-20 12:53:00,Wager,,-10.0,674.0,2451.61
Fanduel,2022-03-20 13:27:00,Wager,,-8.0,904.44,2443.61
Fanduel,2022-03-20 13:28:00,Wager,,-1.0,903.44,2442.61
Draftkings,2022-03-20 19:46:00,Wager,,-20.0,654.0,2422.61
Draftkings,2022-03-20 21:21:00,Winnings,,20.0,674.0,2442.61
Draftkings,2022-03-20 21:22:00,Winnings,,3.2,677.2,2445.81
Fanduel,2022-03-20 23:32:00,Winnings,,41.82,945.26,2487.63
Fanduel,2022-03-20 23:37:00,Winnings,Bonus,8.0,953.26,2495.63
Fanduel,2022-03-21 00:01:00,Winnings,Bonus,8.0,961.26,2503.63
Fanduel,2022-03-21 00:42:00,Winnings,,51.85,1013.11,2555.48
Draftkings,2022-03-21 21:01:00,Wager,,-3.0,669.2,2547.48
Draftkings,2022-03-21 21:01:00,Wager,,-5.0,672.2,2550.48
Draftkings,2022-03-22 02:11:00,Winnings,,0.68,675.6,2553.88
Draftkings,2022-03-22 02:11:00,Winnings,,5.72,674.92,2553.2
Caesars,2022-03-22 23:37:00,Wager,,-50.0,815.17,2503.2
Fanduel,2022-03-23 10:54:00,Wager,,-3.0,1010.11,2500.2
Fanduel,2022-03-23 10:54:00,Winnings,,7.0,1010.11,2500.2
Fanduel,2022-03-23 10:54:00,Wager,,-7.0,1003.11,2493.2
Caesars,2022-03-23 19:02:00,Wager,,-6.0,809.17,2487.2
Caesars,2022-03-23 19:15:00,Winnings,,91.67,900.84,2578.87
Fanduel,2022-03-24 19:00:00,Wager,,-8.0,1002.11,2577.87
Fanduel,2022-03-24 19:05:00,Wager,,-8.0,994.11,2569.87
Fanduel,2022-03-24 19:09:00,Wager,,-8.0,986.11,2561.87
Fanduel,2022-03-24 19:16:00,Wager,,-8.0,978.11,2553.87
Fanduel,2022-03-24 19:20:00,Wager,,-6.0,972.11,2547.87
Caesars,2022-03-24 19:23:00,Wager,,-7.84,893.0,2540.03
Draftkings,2022-03-24 19:31:00,Wager,,-10.0,665.6,2530.71
Fanduel,2022-03-24 22:20:00,Winnings,,40.13,1012.24,2570.84
Fanduel,2022-03-24 22:51:00,Winnings,Bonus,8.0,1020.24,2578.84
Fanduel,2022-03-25 00:17:00,Winnings,Bonus,8.0,1028.24,2586.84
Fanduel,2022-03-25 00:30:00,Winnings,Bonus,8.0,1036.24,2594.84
Caesars,2022-03-25 09:36:00,Winnings,Bonus,25.0,893.0,2594.84
Caesars,2022-03-25 09:36:00,Wager,,-25.0,893.0,2594.84
Fanduel,2022-03-25 17:16:00,Wager,,-8.0,1028.24,2586.84
Fanduel,2022-03-25 19:06:00,Wager,,-8.0,1020.24,2578.84
Fanduel,2022-03-25 19:09:00,Wager,,-8.0,1012.24,2570.84
Fanduel,2022-03-25 19:13:00,Wager,,-8.0,1004.24,2562.84
Fanduel,2022-03-25 20:28:00,Wager,,-5.0,999.24,2557.84
Draftkings,2022-03-25 21:40:00,Wager,,-8.0,657.6,2549.84
Fanduel,2022-03-25 23:54:00,Winnings,Bonus,8.0,1007.24,2557.84
Fanduel,2022-03-25 23:55:00,Winnings,Bonus,8.0,1015.24,2565.84
Caesars,2022-03-26 00:13:00,Wager,,-3.0,890.0,2562.84
Fanduel,2022-03-26 00:29:00,Winnings,Bonus,8.0,1023.24,2570.84
Caesars,2022-03-26 00:31:00,Winnings,,40.0,930.0,2610.84
Fanduel,2022-03-26 16:44:00,Wager,,-8.0,1015.24,2602.84
Fanduel,2022-03-26 16:48:00,Wager,,-6.0,1001.24,2588.84
Fanduel,2022-03-26 16:48:00,Wager,,-8.0,1007.24,2594.84
Fanduel,2022-03-26 19:49:00,Wager,,-7.0,994.24,2581.84
Draftkings,2022-03-26 19:50:00,Wager,,-7.0,650.6,2574.84
Fanduel,2022-03-26 20:22:00,Wager,,-7.0,987.24,2567.84
Caesars,2022-03-27 10:14:00,Wager,,-5.0,925.0,2562.84
Fanduel,2022-03-27 15:14:00,Winnings,Bonus,8.0,995.24,2570.84
Fanduel,2022-03-27 17:55:00,Winnings,Bonus,7.0,1002.24,2577.84
Fanduel,2022-03-27 19:12:00,Winnings,Bonus,6.0,1008.24,2583.84
Fanduel,2022-03-27 19:25:00,Winnings,Bonus,4.0,1012.24,2587.84
Caesars,2022-03-27 21:57:00,Winnings,,10.19,935.19,2598.03
Fanduel,2022-03-28 20:56:00,Wager,,-20.0,992.24,2578.03
Fanduel,2022-03-28 21:00:00,Wager,,-10.0,982.24,2568.03
Fanduel,2022-03-28 21:01:00,Winnings,,10.0,982.24,2568.03
Fanduel,2022-03-28 21:01:00,Wager,,-10.0,972.24,2558.03
Fanduel,2022-03-28 21:01:00,Winnings,,10.0,982.24,2568.03
Fanduel,2022-03-28 21:01:00,Wager,,-10.0,972.24,2558.03
Fanduel,2022-03-28 21:01:00,Wager,,-10.0,972.24,2558.03
Fanduel,2022-03-28 21:01:00,Winnings,,10.0,982.24,2568.03
Fanduel,2022-03-28 21:01:00,Wager,,-10.0,972.24,2558.03
Fanduel,2022-03-28 21:02:00,Winnings,,10.0,982.24,2568.03
Fanduel,2022-03-28 21:03:00,Winnings,,10.0,982.24,2568.03
Fanduel,2022-03-28 21:03:00,Wager,,-10.0,972.24,2558.03
Fanduel,2022-03-28 21:03:00,Wager,,-8.0,974.24,2560.03
Fanduel,2022-03-28 21:03:00,Winnings,,8.0,982.24,2568.03
Caesars,2022-03-28 21:31:00,Wager,,-10.0,925.19,2558.03
Fanduel,2022-03-28 21:42:00,Winnings,,10.05,992.29,2568.08
Fanduel,2022-03-29 21:28:00,Winnings,Bonus,20.0,1012.29,2588.08
Fanduel,2022-03-29 21:54:00,Wager,,-5.0,1007.29,2583.08
Fanduel,2022-03-30 08:40:00,Wager,,-4.0,1003.29,2579.08
Fanduel,2022-03-30 08:41:00,Winnings,,8.0,1003.29,2579.08
Fanduel,2022-03-30 08:41:00,Wager,,-8.0,987.29,2563.08
Fanduel,2022-03-30 08:41:00,Wager,,-8.0,995.29,2571.08
Fanduel,2022-03-30 08:41:00,Winnings,,8.0,995.29,2571.08
Draftkings,2022-03-30 16:43:00,Wager,,-2.6,648.0,2568.48
Caesars,2022-03-30 16:54:00,Wager,,-20.0,905.19,2548.48
Fanduel,2022-03-30 17:01:00,Wager,,-25.0,986.14,2539.33
Fanduel,2022-03-30 17:01:00,Winnings,,7.85,1011.14,2564.33
Fanduel,2022-03-30 17:02:00,Wager,,-4.0,982.14,2535.33
Caesars,2022-03-30 17:04:00,Wager,,-5.0,905.19,2535.33
Caesars,2022-03-30 17:04:00,Winnings,Bonus,5.0,905.19,2535.33
Caesars,2022-03-30 21:21:00,Winnings,,82.0,987.19,2617.33
Caesars,2022-03-30 22:47:00,Winnings,,10.91,998.1,2628.24
Fanduel,2022-03-31 00:58:00,Winnings,,8.4,990.54,2636.64
Fanduel,2022-03-31 16:37:00,Wager,,-3.0,987.54,2633.64
Fanduel,2022-03-31 19:27:00,Wager,,-10.0,977.54,2623.64
Caesars,2022-03-31 19:28:00,Wager,,-4.1,994.0,2619.54
Caesars,2022-03-31 19:35:00,Wager,,-20.0,974.0,2599.54
Fanduel,2022-03-31 22:28:00,Winnings,Bonus,10.0,987.54,2609.54
Fanduel,2022-04-01 14:07:00,Winnings,Bonus,25.0,1012.54,2634.54
Caesars,2022-04-01 19:21:00,Wager,,-4.0,970.0,2630.54
Draftkings,2022-04-01 19:23:00,Wager,,-5.0,643.0,2625.54
Fanduel,2022-04-01 19:27:00,Wager,,-25.0,987.54,2600.54
Draftkings,2022-04-01 22:50:00,Winnings,,2.62,661.12,2618.66
Draftkings,2022-04-01 22:50:00,Winnings,,15.5,658.5,2616.04
Draftkings,2022-04-02 17:44:00,Wager,,-4.0,657.12,2614.66
Draftkings,2022-04-02 17:49:00,Wager,,-20.0,637.12,2594.66
Draftkings,2022-04-02 17:52:00,Wager,,-3.12,634.0,2591.54
Caesars,2022-04-02 18:01:00,Wager,,-20.0,950.0,2571.54
Caesars,2022-04-02 22:32:00,Winnings,Bonus,10.0,950.0,2571.54
Caesars,2022-04-02 22:32:00,Wager,,-10.0,950.0,2571.54
Draftkings,2022-04-02 22:34:00,Winnings,,9.04,643.04,2580.58
Draftkings,2022-04-02 22:34:00,Winnings,,1.96,645.0,2582.54
Fanduel,2022-04-02 22:51:00,Winnings,,25.0,1012.54,2607.54
Caesars,2022-04-02 23:07:00,Winnings,,21.0,971.0,2628.54
Caesars,2022-04-02 23:08:00,Winnings,,72.89,1043.89,2701.43
Fanduel,2022-04-03 00:09:00,Wager,,-3.0,1009.54,2698.43
Draftkings,2022-04-03 13:56:00,Wager,,-6.0,639.0,2692.43
Draftkings,2022-04-03 17:10:00,Wager,,-4.0,635.0,2688.43
Caesars,2022-04-03 19:14:00,Wager,,-3.89,1040.0,2684.54
Draftkings,2022-04-03 20:47:00,Winnings,,21.0,656.0,2705.54
Draftkings,2022-04-03 20:47:00,Winnings,,4.95,660.95,2710.49
Caesars,2022-04-03 22:15:00,Winnings,,11.14,1051.14,2721.63
Caesars,2022-04-04 18:23:00,Wager,,-2.14,1029.0,2699.49
Caesars,2022-04-04 18:23:00,Wager,,-20.0,1031.14,2701.63
Draftkings,2022-04-04 21:19:00,Wager,,-5.95,655.0,2695.68
Fanduel,2022-04-04 23:06:00,Wager,,-3.0,1006.54,2692.68
Caesars,2022-04-05 21:28:00,Wager,,-11.0,1018.0,2679.54
Fanduel,2022-04-07 11:05:00,Wager,,-20.0,986.54,2659.54
Draftkings,2022-04-07 11:09:00,Wager,,-5.0,650.0,2654.54
Draftkings,2022-04-07 11:11:00,Wager,,-1.0,642.0,2646.54
Draftkings,2022-04-07 11:11:00,Wager,,-7.0,643.0,2647.54
Draftkings,2022-04-07 11:13:00,Wager,,-2.0,640.0,2644.54
Caesars,2022-04-07 11:16:00,Wager,,-2.0,1016.0,2642.54
Draftkings,2022-04-07 14:48:00,Winnings,,9.16,649.16,2651.7
Draftkings,2022-04-07 14:48:00,Winnings,,2.84,652.0,2654.54
Fanduel,2022-04-07 15:39:00,Wager,,-4.0,982.54,2650.54
Fanduel,2022-04-07 20:01:00,Winnings,Bonus,20.0,1002.54,2670.54
Caesars,2022-04-08 10:08:00,Winnings,Bonus,20.0,1016.0,2670.54
Caesars,2022-04-08 10:08:00,Wager,,-20.0,1016.0,2670.54
Draftkings,2022-04-08 17:09:00,Wager,,-7.0,645.0,2663.54
Draftkings,2022-04-08 17:10:00,Wager,,-10.0,635.0,2653.54
Caesars,2022-04-08 20:10:00,Winnings,,13.79,1029.79,2667.33
Fanduel,2022-04-09 11:30:00,Wager,,-3.0,999.54,2664.33
Draftkings,2022-04-09 11:36:00,Wager,,-8.0,627.0,2656.33
Draftkings,2022-04-09 11:41:00,Wager,,-17.0,610.0,2639.33
Draftkings,2022-04-09 18:02:00,Winnings,,4.3,639.5,2668.83
Draftkings,2022-04-09 18:02:00,Winnings,,25.2,635.2,2664.53
Fanduel,2022-04-09 19:20:00,Winnings,,7.8,1007.34,2672.33
Draftkings,2022-04-09 19:32:00,Wager,,-4.5,635.0,2672.13
Draftkings,2022-04-09 19:35:00,Wager,,-4.0,631.0,2668.13
Draftkings,2022-04-09 22:48:00,Winnings,,2.02,645.62,2682.75
Draftkings,2022-04-09 22:48:00,Winnings,,12.6,643.6,2680.73
Draftkings,2022-04-10 12:43:00,Wager,,-17.0,628.62,2665.75
Fanduel,2022-04-10 12:50:00,Wager,,-20.0,987.34,2645.75
Draftkings,2022-04-10 12:55:00,Wager,,-5.0,623.62,2640.75
Draftkings,2022-04-10 12:58:00,Wager,,-2.62,621.0,2638.13
Fanduel,2022-04-10 17:06:00,Winnings,Bonus,20.0,1007.34,2658.13
Draftkings,2022-04-10 19:02:00,Winnings,,5.77,626.77,2663.9
Draftkings,2022-04-10 19:07:00,Winnings,,0.32,627.09,2664.22
Draftkings,2022-04-10 23:18:00,Winnings,,53.55,680.64,2717.77
Draftkings,2022-04-10 23:18:00,Winnings,,36.55,717.19,2754.32
Caesars,2022-04-11 09:29:00,Winnings,Bonus,10.0,1029.79,2754.32
Caesars,2022-04-11 09:29:00,Wager,,-10.0,1029.79,2754.32
Draftkings,2022-04-11 18:27:00,Wager,,-5.0,712.19,2749.32
Draftkings,2022-04-11 18:31:00,Wager,,-4.19,708.0,2745.13
Caesars,2022-04-11 18:35:00,Wager,,-11.0,1029.79,2745.13
Caesars,2022-04-11 18:35:00,Winnings,Bonus,11.0,1029.79,2745.13
Fanduel,2022-04-12 12:08:00,Wager,,-0.1,1007.24,2745.03
Fanduel,2022-04-12 12:10:00,Wager,,-0.1,1007.14,2744.93
Caesars,2022-04-12 16:12:00,Winnings,Bonus,10.0,1029.79,2744.93
Caesars,2022-04-12 16:12:00,Wager,,-10.0,1029.79,2744.93
Caesars,2022-04-12 16:13:00,Winnings,Bonus,10.0,1029.79,2744.93
Caesars,2022-04-12 16:13:00,Wager,,-10.0,1029.79,2744.93
Caesars,2022-04-12 16:14:00,Winnings,Bonus,10.0,1029.79,2744.93
Caesars,2022-04-12 16:14:00,Wager,,-10.0,1029.79,2744.93
Caesars,2022-04-12 16:15:00,Winnings,Bonus,10.0,1029.79,2744.93
Caesars,2022-04-12 16:15:00,Wager,,-10.0,1029.79,2744.93
Fanduel,2022-04-12 16:17:00,Wager,,-20.0,987.14,2724.93
Caesars,2022-04-12 16:33:00,Wager,,-15.0,1014.79,2709.93
Draftkings,2022-04-12 16:36:00,Wager,,-10.0,698.0,2699.93
Draftkings,2022-04-12 16:45:00,Wager,,-12.0,686.0,2687.93
Draftkings,2022-04-12 16:47:00,Wager,,-4.0,682.0,2683.93
Caesars,2022-04-12 19:07:00,Winnings,,9.52,1024.31,2693.45
Draftkings,2022-04-12 21:47:00,Winnings,,33.0,715.0,2726.45
Caesars,2022-04-12 22:27:00,Winnings,,10.0,1034.31,2736.45
Caesars,2022-04-12 23:55:00,Winnings,,11.5,1045.81,2747.95
Caesars,2022-04-13 00:31:00,Winnings,,35.46,1081.27,2783.41
Draftkings,2022-04-13 11:34:00,Wager,,-5.0,710.0,2778.41
Caesars,2022-04-13 11:37:00,Wager,,-10.0,1081.27,2778.41
Caesars,2022-04-13 11:37:00,Winnings,Bonus,10.0,1081.27,2778.41
Caesars,2022-04-13 11:40:00,Winnings,Bonus,10.0,1081.27,2778.41
Caesars,2022-04-13 11:40:00,Wager,,-10.0,1081.27,2778.41
Caesars,2022-04-13 11:41:00,Wager,,-10.0,1081.27,2778.41
Caesars,2022-04-13 11:41:00,Winnings,Bonus,10.0,1081.27,2778.41
Caesars,2022-04-13 11:42:00,Winnings,Bonus,10.0,1081.27,2778.41
Caesars,2022-04-13 11:42:00,Wager,,-10.0,1081.27,2778.41
Caesars,2022-04-13 11:48:00,Wager,,-3.0,1078.27,2775.41
Fanduel,2022-04-13 14:29:00,Wager,,-1.0,986.14,2774.41
Draftkings,2022-04-13 15:36:00,Winnings,,16.75,726.75,2791.16
Draftkings,2022-04-13 15:36:00,Winnings,,2.93,729.68,2794.09
Caesars,2022-04-13 17:04:00,Winnings,,14.0,1092.27,2808.09
Fanduel,2022-04-13 17:34:00,Wager,,-20.0,966.14,2788.09
Draftkings,2022-04-13 18:05:00,Wager,,-5.68,724.0,2782.41
Draftkings,2022-04-13 18:09:00,Wager,,-4.0,720.0,2778.41
Draftkings,2022-04-13 18:11:00,Wager,,-10.0,710.0,2768.41
Draftkings,2022-04-13 21:07:00,Wager,,-5.0,705.0,2763.41
Caesars,2022-04-13 21:36:00,Winnings,,9.09,1101.36,2772.5
Draftkings,2022-04-14 16:23:00,Wager,,-7.0,698.0,2765.5
Draftkings,2022-04-14 16:28:00,Wager,,-10.0,688.0,2755.5
Fanduel,2022-04-14 16:31:00,Wager,,-4.14,962.0,2751.36
Caesars,2022-04-14 19:16:00,Wager,,-50.0,1051.36,2701.36
Fanduel,2022-04-15 00:42:00,Winnings,,9.11,971.11,2710.47
Caesars,2022-04-15 18:32:00,Wager,,-30.0,1021.36,2680.47
Caesars,2022-04-15 18:33:00,Wager,,-4.36,1017.0,2676.11
Fanduel,2022-04-15 18:37:00,Wager,,-10.0,961.11,2666.11
Fanduel,2022-04-15 18:39:00,Wager,,-10.0,951.11,2656.11
Draftkings,2022-04-15 18:43:00,Wager,,-10.0,678.0,2646.11
Draftkings,2022-04-15 18:46:00,Wager,,-5.0,673.0,2641.11
Draftkings,2022-04-15 22:27:00,Winnings,,31.0,704.0,2672.11
Draftkings,2022-04-15 23:23:00,Winnings,,6.75,710.75,2678.86
Draftkings,2022-04-16 01:24:00,Winnings,,29.0,739.75,2707.86
Fanduel,2022-04-16 12:06:00,Winnings,Bonus,10.0,961.11,2717.86
Fanduel,2022-04-16 16:13:00,Wager,,-15.0,946.11,2702.86
Draftkings,2022-04-16 16:15:00,Wager,,-10.0,729.75,2692.86
Draftkings,2022-04-16 16:19:00,Wager,,-7.0,722.75,2685.86
Draftkings,2022-04-16 16:20:00,Wager,,-0.75,722.0,2685.11
Fanduel,2022-04-16 21:30:00,Winnings,Bonus,15.0,961.11,2700.11
Draftkings,2022-04-16 22:21:00,Winnings,,30.1,752.1,2730.21
Fanduel,2022-04-17 13:38:00,Wager,,-10.0,951.11,2720.21
Fanduel,2022-04-17 13:40:00,Wager,,-8.0,943.11,2712.21
Fanduel,2022-04-17 13:44:00,Wager,,-15.0,928.11,2697.21
Fanduel,2022-04-17 13:46:00,Wager,,-15.0,913.11,2682.21
Draftkings,2022-04-17 13:48:00,Wager,,-6.0,746.1,2676.21
Draftkings,2022-04-17 13:50:00,Wager,,-10.0,736.1,2666.21
Fanduel,2022-04-17 18:07:00,Winnings,,18.5,931.61,2684.71
Draftkings,2022-04-17 18:27:00,Winnings,,33.5,769.6,2718.21
Draftkings,2022-04-17 18:45:00,Wager,,-10.0,759.6,2708.21
Draftkings,2022-04-17 18:49:00,Wager,,-4.0,755.6,2704.21
Caesars,2022-04-17 18:59:00,Wager,,-10.0,1007.0,2694.21
Fanduel,2022-04-17 22:32:00,Wager,,-2.0,929.61,2692.21
Fanduel,2022-04-17 23:42:00,Winnings,,30.0,959.61,2722.21
Fanduel,2022-04-18 18:01:00,Wager,,-3.61,956.0,2718.6
Draftkings,2022-04-18 18:05:00,Wager,,-10.0,745.6,2708.6
Fanduel,2022-04-18 18:23:00,Winnings,Bonus,8.0,964.0,2716.6
Draftkings,2022-04-18 23:14:00,Winnings,,37.5,783.1,2754.1
Fanduel,2022-04-19 00:08:00,Wager,,-4.0,960.0,2750.1
Fanduel,2022-04-19 01:26:00,Winnings,,7.4,967.4,2757.5
Fanduel,2022-04-19 18:46:00,Winnings,,10.4,977.8,2767.9
Draftkings,2022-04-19 19:13:00,Wager,,-10.0,773.1,2757.9
Draftkings,2022-04-19 19:16:00,Wager,,-20.0,753.1,2737.9
Caesars,2022-04-19 21:45:00,Wager,,-3.0,1004.0,2734.9
Draftkings,2022-04-19 23:31:00,Wager,,-20.0,733.1,2714.9
Fanduel,2022-04-20 00:24:00,Wager,,-5.0,972.8,2709.9
Fanduel,2022-04-20 00:28:00,Wager,,-8.0,964.8,2701.9
Draftkings,2022-04-20 01:00:00,Winnings,,27.84,760.94,2729.74
Fanduel,2022-04-20 01:01:00,Winnings,,9.5,974.3,2739.24
Fanduel,2022-04-20 08:46:00,Wager,,-4.0,970.3,2735.24
Fanduel,2022-04-20 16:56:00,Wager,,-15.0,955.3,2720.24
Draftkings,2022-04-20 20:29:00,Wager,,-10.0,750.94,2710.24
Draftkings,2022-04-20 20:35:00,Wager,,-10.0,740.94,2700.24
Caesars,2022-04-20 20:40:00,Wager,,-10.0,994.0,2690.24
Draftkings,2022-04-20 21:46:00,Winnings,,3.87,770.31,2719.61
Draftkings,2022-04-20 21:46:00,Winnings,,25.5,766.44,2715.74
Fanduel,2022-04-20 22:07:00,Winnings,Bonus,15.0,970.3,2730.74
Draftkings,2022-04-21 00:25:00,Winnings,,11.9,782.21,2746.51
Fanduel,2022-04-21 11:00:00,Wager,,-5.3,965.0,2741.21
Caesars,2022-04-21 11:08:00,Winnings,Bonus,10.0,994.0,2741.21
Caesars,2022-04-21 11:08:00,Wager,,-10.0,994.0,2741.21
Draftkings,2022-04-21 11:10:00,Wager,,-10.0,772.21,2731.21
Draftkings,2022-04-21 11:14:00,Wager,,-7.21,765.0,2724.0
Draftkings,2022-04-21 15:21:00,Wager,,-10.0,755.0,2714.0
Caesars,2022-04-21 15:56:00,Winnings,,18.0,1012.0,2732.0
Caesars,2022-04-21 15:56:00,Winnings,,18.0,1030.0,2750.0
Fanduel,2022-04-21 17:24:00,Wager,,-4.0,961.0,2746.0
Fanduel,2022-04-21 17:25:00,Wager,,-1.0,960.0,2745.0
Draftkings,2022-04-22 00:23:00,Wager,,-5.0,750.0,2740.0
Draftkings,2022-04-22 00:48:00,Winnings,,9.16,759.16,2749.16
Fanduel,2022-04-22 01:06:00,Winnings,,11.0,971.0,2760.16
Draftkings,2022-04-22 01:07:00,Winnings,,40.0,799.16,2800.16
Draftkings,2022-04-22 10:00:00,Wager,,-10.0,789.16,2790.16
Draftkings,2022-04-22 10:03:00,Wager,,-10.0,779.16,2780.16
Draftkings,2022-04-22 10:07:00,Wager,,-10.0,769.16,2770.16
Caesars,2022-04-22 10:14:00,Wager,,-3.0,1027.0,2767.16
Draftkings,2022-04-22 22:03:00,Winnings,,6.0,775.16,2773.16
Draftkings,2022-04-22 22:15:00,Winnings,,40.0,815.16,2813.16
Draftkings,2022-04-22 22:15:00,Winnings,,15.0,830.16,2828.16
Draftkings,2022-04-22 22:38:00,Winnings,,16.0,888.16,2886.16
Draftkings,2022-04-22 22:38:00,Winnings,,42.0,872.16,2870.16
Fanduel,2022-04-23 12:18:00,Wager,,-12.0,959.0,2858.16
Fanduel,2022-04-23 12:19:00,Winnings,,12.0,971.0,2870.16
Fanduel,2022-04-23 12:22:00,Wager,,-10.0,961.0,2860.16
Draftkings,2022-04-23 12:26:00,Wager,,-10.0,878.16,2866.16
Draftkings,2022-04-23 12:28:00,Wager,,-5.16,873.0,2861.0
Caesars,2022-04-23 12:38:00,Wager,,-18.0,1009.0,2843.0
Draftkings,2022-04-23 22:01:00,Winnings,,14.5,887.5,2857.5
Draftkings,2022-04-23 22:08:00,Winnings,,15.99,903.49,2873.49
Draftkings,2022-04-23 22:08:00,Winnings,,2.71,906.2,2876.2
Fanduel,2022-04-24 01:19:00,Winnings,Bonus,10.0,1022.92,2938.12
Fanduel,2022-04-24 01:19:00,Winnings,,51.92,1012.92,2928.12
Draftkings,2022-04-24 12:36:00,Wager,,-10.0,896.2,2918.12
Draftkings,2022-04-24 12:40:00,Wager,,-10.0,886.2,2908.12
Caesars,2022-04-24 12:45:00,Wager,,-10.0,999.0,2898.12
Caesars,2022-04-24 12:47:00,Wager,,-3.0,996.0,2895.12
Draftkings,2022-04-24 12:51:00,Wager,,-10.0,876.2,2885.12
Fanduel,2022-04-24 12:58:00,Wager,,-5.0,1017.92,2890.12
Fanduel,2022-04-24 12:58:00,Wager,,-5.0,1012.92,2885.12
Fanduel,2022-04-24 12:58:00,Wager,,-5.0,1007.92,2880.12
Fanduel,2022-04-24 21:45:00,Winnings,,12.5,1020.42,2892.62
Draftkings,2022-04-25 13:00:00,Wager,,-5.0,871.2,2887.62
Draftkings,2022-04-25 13:01:00,Wager,,-5.0,866.2,2882.62
Draftkings,2022-04-25 13:06:00,Wager,,-10.0,856.2,2872.62
Caesars,2022-04-25 13:09:00,Wager,,-3.0,993.0,2869.62
Fanduel,2022-04-25 13:11:00,Wager,,-15.0,1005.42,2854.62
Caesars,2022-04-25 22:52:00,Winnings,,3.0,996.0,2857.62
Draftkings,2022-04-26 15:29:00,Wager,,-15.0,841.2,2842.62
Draftkings,2022-04-26 15:30:00,Wager,,-1.2,840.0,2841.42
Draftkings,2022-04-26 15:37:00,Wager,,-10.0,830.0,2831.42
Draftkings,2022-04-26 15:38:00,Wager,,-5.0,825.0,2826.42
Caesars,2022-04-26 15:43:00,Wager,,-4.0,992.0,2822.42
Draftkings,2022-04-26 21:49:00,Winnings,,1.27,832.53,2829.95
Draftkings,2022-04-26 21:49:00,Winnings,,6.26,831.26,2828.68
Caesars,2022-04-26 23:22:00,Winnings,,7.88,999.88,2836.56
Draftkings,2022-04-27 01:00:00,Winnings,,36.5,869.03,2874.33
Fanduel,2022-04-27 12:06:00,Wager,,-1.0,1004.42,2873.33
Draftkings,2022-04-27 20:44:00,Wager,,-10.0,859.03,2863.33
Draftkings,2022-04-27 20:50:00,Wager,,-4.0,855.03,2859.33
Caesars,2022-04-27 21:00:00,Wager,,-10.0,989.88,2849.33
Fanduel,2022-04-27 21:10:00,Wager,,-13.0,991.42,2836.33
Caesars,2022-04-27 21:15:00,Winnings,,10.0,999.88,2846.33
Draftkings,2022-04-28 18:02:00,Wager,,-10.0,845.03,2836.33
Fanduel,2022-04-28 20:13:00,Winnings,Bonus,13.0,1004.42,2849.33
Fanduel,2022-04-29 16:54:00,Wager,,-11.0,993.42,2838.33
Draftkings,2022-04-29 16:57:00,Wager,,-10.0,835.03,2828.33
Draftkings,2022-04-29 16:59:00,Wager,,-5.0,830.03,2823.33
Caesars,2022-04-29 17:03:00,Wager,,-1.0,997.88,2821.33
Caesars,2022-04-29 17:03:00,Wager,,-1.0,998.88,2822.33
Caesars,2022-04-29 17:08:00,Wager,,-10.0,997.88,2821.33
Caesars,2022-04-29 17:08:00,Winnings,Bonus,10.0,997.88,2821.33
Fanduel,2022-04-29 17:10:00,Wager,,-2.42,991.0,2818.91
Caesars,2022-04-29 20:35:00,Winnings,,5.13,1003.01,2824.04
Fanduel,2022-04-29 21:49:00,Wager,,-10.0,981.0,2814.04
Fanduel,2022-04-29 21:50:00,Wager,,-2.0,979.0,2812.04
Draftkings,2022-04-29 22:05:00,Winnings,,13.0,843.03,2825.04
Fanduel,2022-04-29 22:52:00,Winnings,Bonus,11.0,990.0,2836.04
Draftkings,2022-04-30 01:04:00,Winnings,,11.5,854.53,2847.54
Caesars,2022-04-30 11:17:00,Wager,,-2.0,1001.01,2845.54
Caesars,2022-04-30 11:17:00,Wager,,-3.0,998.01,2842.54
Draftkings,2022-04-30 11:20:00,Wager,,-7.53,847.0,2835.01
Caesars,2022-04-30 11:24:00,Wager,,-3.01,995.0,2832.0
Caesars,2022-04-30 17:01:00,Winnings,,6.69,1001.69,2838.69
Fanduel,2022-04-30 17:35:00,Wager,,-3.0,987.0,2835.69
Caesars,2022-05-01 14:08:00,Wager,,-3.69,998.0,2832.0
Draftkings,2022-05-01 14:38:00,Wager,,-10.0,837.0,2822.0
Draftkings,2022-05-01 14:50:00,Wager,,-8.0,829.0,2814.0
Fanduel,2022-05-01 15:56:00,Wager,,-10.0,977.0,2804.0
Caesars,2022-05-01 16:36:00,Wager,,-11.0,987.0,2793.0
Draftkings,2022-05-01 17:00:00,Winnings,,4.76,833.76,2797.76
Caesars,2022-05-01 17:37:00,Winnings,,8.71,995.71,2806.47
Fanduel,2022-05-01 21:17:00,Winnings,Bonus,10.0,987.0,2816.47
Draftkings,2022-05-01 21:50:00,Winnings,,27.2,860.96,2843.67
Draftkings,2022-05-01 21:50:00,Winnings,,9.6,870.56,2853.27
Caesars,2022-05-02 12:04:00,Wager,,-3.71,992.0,2849.56
Draftkings,2022-05-02 17:22:00,Wager,,-10.0,860.56,2839.56
Draftkings,2022-05-02 17:25:00,Wager,,-10.0,850.56,2829.56
Draftkings,2022-05-02 17:28:00,Wager,,-7.0,843.56,2822.56
Fanduel,2022-05-02 18:38:00,Wager,,-13.0,974.0,2809.56
Draftkings,2022-05-03 18:34:00,Wager,,-20.0,823.56,2789.56
Draftkings,2022-05-03 18:35:00,Wager,,-10.0,813.56,2779.56
Draftkings,2022-05-04 00:30:00,Winnings,,62.0,957.56,2923.56
Draftkings,2022-05-04 00:30:00,Winnings,,82.0,895.56,2861.56
Draftkings,2022-05-04 07:23:00,Wager,,-10.0,947.56,2913.56
Draftkings,2022-05-04 07:28:00,Wager,,-10.0,937.56,2903.56
Caesars,2022-05-04 08:20:00,Wager,,-7.0,985.0,2896.56
Draftkings,2022-05-05 18:30:00,Wager,,-10.0,927.56,2886.56
Fanduel,2022-05-05 19:27:00,Wager,,-11.0,963.0,2875.56
Caesars,2022-05-05 19:34:00,Winnings,Bonus,11.0,985.0,2875.56
Caesars,2022-05-05 19:34:00,Wager,,-11.0,985.0,2875.56
Fanduel,2022-05-05 19:36:00,Wager,,-11.0,952.0,2864.56
Fanduel,2022-05-06 00:50:00,Winnings,,24.75,976.75,2889.31
Caesars,2022-05-06 09:45:00,Wager,,-3.0,982.0,2886.31
Draftkings,2022-05-06 17:15:00,Wager,,-10.0,917.56,2876.31
Draftkings,2022-05-06 17:21:00,Wager,,-6.0,911.56,2870.31
Caesars,2022-05-06 19:01:00,Winnings,,3.0,985.0,2873.31
Fanduel,2022-05-06 21:45:00,Winnings,Bonus,11.0,987.75,2884.31
Draftkings,2022-05-07 17:29:00,Wager,,-10.0,901.56,2874.31
Draftkings,2022-05-07 17:31:00,Wager,,-7.0,894.56,2867.31
Fanduel,2022-05-07 17:51:00,Wager,,-10.0,977.75,2857.31
Fanduel,2022-05-07 17:52:00,Wager,,-2.75,975.0,2854.56
Fanduel,2022-05-07 23:12:00,Winnings,,20.0,995.0,2874.56
Draftkings,2022-05-08 11:44:00,Wager,,-10.0,884.56,2864.56
Draftkings,2022-05-08 11:45:00,Wager,,-7.0,877.56,2857.56
Fanduel,2022-05-08 12:33:00,Wager,,-10.0,985.0,2847.56
Caesars,2022-05-08 12:43:00,Wager,,-10.0,975.0,2837.56
Draftkings,2022-05-08 18:30:00,Winnings,,26.5,904.06,2864.06
Fanduel,2022-05-08 21:22:00,Wager,,-4.0,981.0,2860.06
Fanduel,2022-05-08 22:06:00,Winnings,,56.03,1037.03,2916.09
Fanduel,2022-05-08 22:07:00,Winnings,Bonus,10.0,1047.03,2926.09
Fanduel,2022-05-08 22:55:00,Wager,,-10.0,1037.03,2916.09
Draftkings,2022-05-09 07:57:00,Wager,,-7.0,897.06,2909.09
Draftkings,2022-05-09 07:58:00,Wager,,-10.0,887.06,2899.09
Fanduel,2022-05-09 20:42:00,Wager,,-1.03,1036.0,2898.06
Draftkings,2022-05-09 23:38:00,Winnings,,14.98,902.04,2913.04
Draftkings,2022-05-10 17:13:00,Wager,,-20.0,882.04,2893.04
Draftkings,2022-05-10 17:42:00,Wager,,-10.0,872.04,2883.04
Draftkings,2022-05-10 17:45:00,Wager,,-7.0,865.04,2876.04
Caesars,2022-05-10 19:32:00,Wager,,-7.0,975.0,2876.04
Caesars,2022-05-10 19:32:00,Winnings,Bonus,7.0,975.0,2876.04
Draftkings,2022-05-11 02:21:00,Winnings,,31.0,896.04,2907.04
Draftkings,2022-05-11 16:04:00,Wager,,-7.0,889.04,2900.04
Fanduel,2022-05-11 19:38:00,Wager,,-13.0,1023.0,2887.04
Caesars,2022-05-11 19:40:00,Wager,,-4.0,971.0,2883.04
Draftkings,2022-05-11 21:01:00,Winnings,,28.7,917.74,2911.74
Caesars,2022-05-11 22:52:00,Winnings,,8.96,979.96,2920.7
Fanduel,2022-05-12 00:01:00,Winnings,Bonus,13.0,1036.0,2933.7
Draftkings,2022-05-12 10:32:00,Wager,,-6.0,911.74,2927.7
Draftkings,2022-05-12 10:34:00,Wager,,-10.0,901.74,2917.7
Fanduel,2022-05-12 11:36:00,Wager,,-11.0,1025.0,2906.7
Caesars,2022-05-12 16:32:00,Wager,,-5.96,974.0,2900.74
Draftkings,2022-05-12 20:48:00,Winnings,,22.0,923.74,2922.74
Draftkings,2022-05-12 23:38:00,Winnings,,15.3,939.04,2938.04
Caesars,2022-05-13 00:12:00,Winnings,,3.43,977.43,2941.47
Draftkings,2022-05-13 11:09:00,Wager,,-4.04,935.0,2937.43
Draftkings,2022-05-13 11:10:00,Wager,,-8.0,927.0,2929.43
Draftkings,2022-05-13 11:11:00,Wager,,-5.0,922.0,2924.43
Fanduel,2022-05-13 12:04:00,Wager,,-13.0,1012.0,2911.43
Caesars,2022-05-13 12:16:00,Winnings,Bonus,10.0,977.43,2911.43
Caesars,2022-05-13 12:16:00,Wager,,-10.0,977.43,2911.43
Caesars,2022-05-13 12:19:00,Wager,,-75.0,902.43,2836.43
Draftkings,2022-05-13 22:03:00,Winnings,,14.5,936.5,2850.93
Caesars,2022-05-13 22:49:00,Winnings,,121.88,1024.31,2972.81
Caesars,2022-05-14 18:42:00,Winnings,Bonus,25.0,1024.31,2972.81
Caesars,2022-05-14 18:42:00,Wager,,-25.0,1024.31,2972.81
Caesars,2022-05-14 22:42:00,Winnings,,41.5,1065.81,3014.31
Fanduel,2022-05-15 13:40:00,Wager,,-10.0,1002.0,3004.31
Fanduel,2022-05-15 13:42:00,Wager,,-10.0,992.0,2994.31
Draftkings,2022-05-15 15:06:00,Wager,,-10.0,926.5,2984.31
Draftkings,2022-05-15 15:08:00,Wager,,-5.0,921.5,2979.31
Caesars,2022-05-15 16:25:00,Wager,,-9.0,1056.81,2970.31
Fanduel,2022-05-15 16:57:00,Winnings,Bonus,10.0,1002.0,2980.31
Fanduel,2022-05-15 18:12:00,Winnings,Bonus,10.0,1012.0,2990.31
Draftkings,2022-05-17 15:01:00,Wager,,-20.0,901.5,2970.31
Draftkings,2022-05-17 15:08:00,Wager,,-7.5,894.0,2962.81
Draftkings,2022-05-17 15:10:00,Wager,,-4.0,890.0,2958.81
Draftkings,2022-05-17 21:34:00,Winnings,,22.4,912.4,2981.21
Draftkings,2022-05-18 12:58:00,Wager,,-9.0,903.4,2972.21
Fanduel,2022-05-19 10:30:00,Wager,,-10.0,1002.0,2962.21
Fanduel,2022-05-19 16:53:00,Winnings,,30.0,1032.0,2992.21
Draftkings,2022-05-19 18:38:00,Wager,,-2.4,901.0,2989.81
Draftkings,2022-05-19 18:42:00,Wager,,-8.0,893.0,2981.81
Draftkings,2022-05-19 18:43:00,Wager,,-10.0,883.0,2971.81
Draftkings,2022-05-20 14:53:00,Wager,,-3.0,880.0,2968.81
Draftkings,2022-05-20 14:56:00,Wager,,-8.0,872.0,2960.81
Fanduel,2022-05-20 15:51:00,Wager,,-10.0,1022.0,2950.81
Fanduel,2022-05-20 15:52:00,Wager,,-10.0,1012.0,2940.81
Fanduel,2022-05-20 22:16:00,Winnings,,27.0,1039.0,2967.81
Draftkings,2022-05-21 20:25:00,Wager,,-12.0,860.0,2955.81
Draftkings,2022-05-21 20:31:00,Wager,,-6.0,854.0,2949.81
Draftkings,2022-05-21 20:35:00,Winnings,,6.0,860.0,2955.81
Draftkings,2022-05-21 20:56:00,Winnings,,3.57,863.57,2959.38
Fanduel,2022-05-21 21:14:00,Winnings,,0.33,1039.33,2959.71
Draftkings,2022-05-21 22:19:00,Winnings,,22.43,886.0,2982.14
Draftkings,2022-05-21 22:20:00,Winnings,,3.55,889.55,2985.69
Draftkings,2022-05-21 23:09:00,Wager,,4.55,889.55,2985.69
Draftkings,2022-05-21 23:09:00,Wager,,-4.55,885.0,2981.14
Draftkings,2022-05-21 23:10:00,Wager,,-4.55,885.0,2981.14
Fanduel,2022-05-22 13:42:00,Wager,,-10.0,1029.33,2971.14
Fanduel,2022-05-22 21:41:00,Winnings,Bonus,10.0,1039.33,2981.14
Draftkings,2022-05-23 18:31:00,Wager,,-10.0,875.0,2971.14
Draftkings,2022-05-23 18:33:00,Wager,,-7.0,868.0,2964.14
Draftkings,2022-05-23 23:57:00,Wager,,-5.0,863.0,2959.14
Draftkings,2022-05-24 18:03:00,Wager,,-20.0,843.0,2939.14
Draftkings,2022-05-24 18:04:00,Wager,,-10.0,833.0,2929.14
Draftkings,2022-05-24 18:11:00,Wager,,-3.0,830.0,2926.14
Fanduel,2022-05-24 19:09:00,Wager,,-10.0,1029.33,2916.14
Fanduel,2022-05-24 23:03:00,Winnings,Bonus,10.0,1039.33,2926.14
Draftkings,2022-05-25 18:02:00,Wager,,-10.0,820.0,2916.14
Draftkings,2022-05-25 18:03:00,Wager,,-7.0,813.0,2909.14
Fanduel,2022-05-26 17:06:00,Winnings,Bonus,50.0,1089.33,2959.14
Draftkings,2022-05-26 17:34:00,Wager,,-8.0,805.0,2951.14
Draftkings,2022-05-26 17:35:00,Wager,,-5.0,800.0,2946.14
Draftkings,2022-05-26 23:32:00,Wager,,-7.0,793.0,2939.14
Draftkings,2022-05-28 19:54:00,Wager,,-2.0,791.0,2937.14
Draftkings,2022-05-28 19:55:00,Wager,,-3.0,788.0,2934.14
Fanduel,2022-05-28 21:00:00,Wager,,-10.0,1079.33,2924.14
Fanduel,2022-05-28 21:06:00,Wager,,-50.0,1029.33,2874.14
Fanduel,2022-05-29 07:07:00,Winnings,,49.02,1078.35,2923.16
Draftkings,2022-05-29 14:49:00,Wager,,-10.0,778.0,2913.16
Fanduel,2022-05-30 01:01:00,Wager,,-10.0,1068.35,2903.16
Fanduel,2022-05-30 01:05:00,Wager,,-5.0,1063.35,2898.16
Fanduel,2022-05-30 01:07:00,Wager,,-5.0,1058.35,2893.16
Fanduel,2022-05-30 17:07:00,Wager,,-3.35,1055.0,2889.81
Fanduel,2022-05-30 18:02:00,Winnings,,51.52,1106.52,2941.33
Draftkings,2022-05-30 20:31:00,Wager,,-5.0,773.0,2936.33
Fanduel,2022-05-30 21:28:00,Wager,,-10.0,1096.52,2926.33
Draftkings,2022-05-31 00:39:00,Winnings,,3.97,795.22,2948.55
Draftkings,2022-05-31 00:39:00,Winnings,,18.25,791.25,2944.58
Draftkings,2022-05-31 16:34:00,Wager,,-20.0,775.22,2928.55
Fanduel,2022-05-31 17:37:00,Wager,,-3.52,1093.0,2925.03
Fanduel,2022-06-01 13:55:00,Winnings,Bonus,10.0,1103.0,2935.03
Draftkings,2022-06-02 18:22:00,Wager,,-15.0,765.7,2925.51
Draftkings,2022-06-02 18:24:00,Wager,,-10.0,755.7,2915.51
Draftkings,2022-06-02 18:30:00,Wager,,-4.0,751.7,2911.51
Draftkings,2022-06-02 18:31:00,Wager,,-5.0,746.7,2906.51
Fanduel,2022-06-02 19:17:00,Wager,,-5.0,1098.0,2901.51
Fanduel,2022-06-02 19:20:00,Wager,,-13.0,1085.0,2888.51
Fanduel,2022-06-02 23:31:00,Winnings,Bonus,13.0,1098.0,2901.51
Draftkings,2022-06-03 11:15:00,Winnings,Bonus,24.38,771.08,2925.89
Draftkings,2022-06-03 12:58:00,Wager,,-6.0,765.08,2919.89
Draftkings,2022-06-03 13:10:00,Wager,,-3.0,762.08,2916.89
Fanduel,2022-06-03 13:53:00,Wager,,-12.0,1086.0,2904.89
Fanduel,2022-06-03 15:59:00,Winnings,Bonus,12.0,1098.0,2916.89
Draftkings,2022-06-03 16:46:00,Winnings,,1.5,772.58,2927.39
Draftkings,2022-06-03 16:46:00,Winnings,,9.0,771.08,2925.89
Draftkings,2022-06-04 14:27:00,Wager,,-6.0,766.58,2921.39
Draftkings,2022-06-04 14:28:00,Wager,,-1.0,765.58,2920.39
Draftkings,2022-06-04 14:28:00,Wager,,1.0,766.58,2921.39
Fanduel,2022-06-05 18:53:00,Wager,,-10.0,1088.0,2911.39
Fanduel,2022-06-05 23:07:00,Winnings,Bonus,10.0,1151.7,2975.09
Fanduel,2022-06-05 23:07:00,Winnings,,53.7,1141.7,2965.09
Draftkings,2022-06-06 16:57:00,Wager,,-10.0,751.58,2950.09
Draftkings,2022-06-06 16:57:00,Wager,,-5.0,761.58,2960.09
Fanduel,2022-06-06 17:55:00,Wager,,-11.0,1140.7,2959.09
Fanduel,2022-06-07 01:11:00,Winnings,Bonus,11.0,1151.7,2970.09
Draftkings,2022-06-07 16:04:00,Wager,,-20.0,731.58,2940.09
Draftkings,2022-06-07 16:06:00,Wager,,-10.0,721.58,2930.09
Fanduel,2022-06-07 17:09:00,Wager,,-10.0,1141.7,2920.09
Draftkings,2022-06-08 18:28:00,Wager,,-0.58,721.0,2919.51
Fanduel,2022-06-08 19:24:00,Wager,,-13.0,1128.7,2906.51
Fanduel,2022-06-08 23:35:00,Winnings,,26.0,1154.7,2932.51
Draftkings,2022-06-08 23:46:00,Winnings,,2.17,723.17,2934.68
Fanduel,2022-06-09 18:33:00,Wager,,-12.0,1142.7,2922.68
Fanduel,2022-06-10 17:00:00,Wager,,-10.0,1132.7,2912.68
Fanduel,2022-06-10 17:32:00,Wager,,-15.0,1117.7,2897.68
Fanduel,2022-06-10 23:31:00,Winnings,Bonus,15.0,1132.7,2912.68
Fanduel,2022-06-11 11:04:00,Wager,,-12.0,1120.7,2900.68
Draftkings,2022-06-11 13:19:00,Wager,,-10.0,713.17,2890.68
Draftkings,2022-06-11 13:24:00,Wager,,-20.0,693.17,2870.68
Fanduel,2022-06-11 17:48:00,Winnings,Bonus,12.0,1132.7,2882.68
Draftkings,2022-06-12 09:22:00,Wager,,-10.0,683.17,2872.68
Fanduel,2022-06-12 10:27:00,Wager,,-10.0,1122.7,2862.68
Fanduel,2022-06-12 10:28:00,Wager,,-11.0,1111.7,2851.68
Fanduel,2022-06-12 10:31:00,Wager,,-12.0,1099.7,2839.68
Draftkings,2022-06-12 16:39:00,Winnings,,10.0,693.17,2849.68
Fanduel,2022-06-12 22:23:00,Winnings,Bonus,10.0,1165.13,2915.11
Fanduel,2022-06-12 22:23:00,Winnings,,55.43,1155.13,2905.11
Draftkings,2022-06-12 22:26:00,Wager,,-3.17,690.0,2901.94
Draftkings,2022-06-13 14:30:00,Wager,,-5.0,685.0,2896.94
Fanduel,2022-06-13 15:41:00,Wager,,-15.0,1150.13,2891.94
Fanduel,2022-06-13 15:44:00,Wager,,-10.0,1140.13,2881.94
Draftkings,2022-06-13 20:13:00,Winnings,,25.0,710.0,2906.94
Fanduel,2022-06-13 22:55:00,Winnings,,16.0,1156.13,2922.94
Draftkings,2022-06-14 08:09:00,Wager,,-10.0,700.0,2912.94
Fanduel,2022-06-14 09:10:00,Wager,,-1.13,1155.0,2911.81
Fanduel,2022-06-14 22:35:00,Winnings,,2.35,1157.35,2914.16
Draftkings,2022-06-15 22:28:00,Winnings,,25.0,725.0,2939.16
Draftkings,2022-06-21 17:25:00,Wager,,-10.0,715.0,2929.16
Fanduel,2022-06-21 18:22:00,Wager,,-7.35,1150.0,2921.81
Draftkings,2022-06-21 22:39:00,Winnings,,27.0,742.0,2948.81
Draftkings,2022-06-22 10:06:00,Wager,,-10.0,732.0,2938.81
Draftkings,2022-06-22 10:10:00,Wager,,-2.0,730.0,2936.81
Draftkings,2022-06-22 23:34:00,Winnings,,33.0,763.0,2969.81
Draftkings,2022-06-23 13:05:00,Wager,,-10.0,753.0,2959.81
Fanduel,2022-06-25 14:07:00,Wager,,-15.0,1135.0,2944.81
Fanduel,2022-06-25 15:46:00,Wager,,-5.0,1130.0,2939.81
Fanduel,2022-06-25 17:43:00,Winnings,,79.17,1209.17,3018.98
Fanduel,2022-06-25 17:43:00,Winnings,Bonus,15.0,1224.17,3033.98
Draftkings,2022-06-26 11:24:00,Wager,,-3.0,750.0,3030.98
Fanduel,2022-06-26 12:23:00,Wager,,-10.0,1214.17,3020.98
Fanduel,2022-06-26 19:23:00,Winnings,Bonus,10.0,1224.17,3030.98
Fanduel,2022-06-28 19:30:00,Wager,,-10.0,1214.17,3020.98
Fanduel,2022-06-28 22:48:00,Winnings,,23.0,1237.17,3043.98
Fanduel,2022-06-29 17:23:00,Wager,,-2.17,1235.0,3041.81
Draftkings,2022-07-01 08:33:00,Wager,,-5.0,745.0,3036.81
Fanduel,2022-07-01 09:24:00,Wager,,-15.0,1220.0,3021.81
Fanduel,2022-07-02 15:36:00,Wager,,-25.0,1195.0,2996.81
Fanduel,2022-07-03 15:06:00,Winnings,Bonus,25.0,1220.0,3021.81
Draftkings,2022-07-04 19:23:00,Wager,,-10.0,735.0,3011.81
Draftkings,2022-07-04 19:24:00,Wager,,-10.0,725.0,3001.81
Fanduel,2022-07-05 16:54:00,Wager,,-25.0,1195.0,2976.81
Fanduel,2022-07-05 16:57:00,Wager,,-25.0,1170.0,2951.81
Fanduel,2022-07-06 12:29:00,Winnings,Bonus,10.0,1180.0,2961.81
Fanduel,2022-07-07 19:02:00,Wager,,-10.0,1170.0,2951.81
Fanduel,2022-07-07 23:10:00,Winnings,,20.5,1190.5,2972.31
Draftkings,2022-07-09 10:50:00,Wager,,-10.0,715.0,2962.31
Draftkings,2022-07-13 18:39:00,Wager,,-5.0,710.0,2957.31
Fanduel,2022-07-14 16:35:00,Wager,,-25.0,1165.5,2932.31
Fanduel,2022-07-15 11:40:00,Winnings,Bonus,24.0,1189.5,2956.31
Fanduel,2022-07-15 19:10:00,Wager,,-24.0,1165.5,2932.31
Fanduel,2022-07-18 19:14:00,Wager,,-5.5,1160.0,2926.81
Fanduel,2022-07-18 19:14:00,Wager,,-5.5,1160.0,2926.81
Fanduel,2022-07-18 19:14:00,Winnings,,5.5,1165.5,2932.31
Draftkings,2022-07-19 22:25:00,Wager,,-2.0,708.0,2930.31
Fanduel,2022-07-21 02:49:00,Winnings,Bonus,15.0,1234.17,2998.98
Fanduel,2022-07-21 02:49:00,Winnings,Bonus,59.17,1219.17,2983.98
Fanduel,2022-07-22 17:58:00,Winnings,Bonus,-59.17,1175.0,2939.81
Fanduel,2022-07-22 18:00:00,Winnings,Bonus,20.0,1195.0,2959.81
Fanduel,2022-07-23 14:54:00,Wager,,-20.0,1175.0,2939.81
Fanduel,2022-07-23 20:28:00,Winnings,Bonus,10.0,1185.0,2949.81
Fanduel,2022-07-25 12:14:00,Winnings,Bonus,-15.0,1170.0,2934.81
Draftkings,2022-07-25 19:35:00,Wager,,-5.0,703.0,2929.81
Fanduel,2022-07-25 20:33:00,Wager,,-10.0,1160.0,2919.81
Fanduel,2022-07-26 19:52:00,Wager,,-20.0,1140.0,2899.81
Draftkings,2022-07-28 19:16:00,Wager,,-8.0,695.0,2891.81
Draftkings,2022-07-28 23:56:00,Winnings,,5.0,728.0,2924.81
Draftkings,2022-07-28 23:56:00,Winnings,,28.0,723.0,2919.81
Fanduel,2022-07-29 16:57:00,Wager,,-2.0,1138.0,2917.81
Fanduel,2022-07-29 17:01:00,Wager,,-8.0,1130.0,2909.81
Draftkings,2022-07-30 13:30:00,Wager,,-20.0,708.0,2894.81
Fanduel,2022-07-31 20:26:00,Winnings,,12.0,1142.0,2906.81
Draftkings,2022-08-01 10:56:00,Wager,,-6.0,702.0,2900.81
Draftkings,2022-08-02 19:11:00,Wager,,-5.0,697.0,2895.81
Fanduel,2022-08-05 12:50:00,Wager,,-2.0,1140.0,2893.81
Fanduel,2022-08-05 13:04:00,Wager,,-2.0,1140.0,2893.81
Fanduel,2022-08-05 13:04:00,Winnings,,2.0,1142.0,2895.81
Fanduel,2022-08-06 22:34:00,Wager,,-10.0,1130.0,2883.81
Fanduel,2022-08-07 12:19:00,Winnings,Bonus,10.0,1140.0,2893.81
Fanduel,2022-08-12 16:58:00,Wager,,-10.0,1130.0,2883.81
Fanduel,2022-08-12 17:00:00,Wager,,-10.0,1120.0,2873.81
Fanduel,2022-08-12 23:10:00,Winnings,,20.0,1140.0,2893.81
Fanduel,2022-08-13 11:53:00,Winnings,Bonus,10.0,1150.0,2903.81
Draftkings,2022-08-17 22:31:00,Wager,,-3.0,694.0,2900.81
Fanduel,2022-08-17 23:29:00,Wager,,-10.0,1140.0,2890.81
Fanduel,2022-08-18 16:04:00,Winnings,,17.5,1157.5,2908.31
Fanduel,2022-08-20 15:51:00,Wager,,-7.5,1150.0,2900.81
Fanduel,2022-08-23 19:59:00,Wager,,-10.0,1140.0,2890.81
Fanduel,2022-08-23 20:00:00,Wager,,-5.0,1135.0,2885.81
Fanduel,2022-08-23 20:02:00,Wager,,-25.0,1110.0,2860.81
Fanduel,2022-08-23 22:44:00,Wager,,-20.0,1090.0,2840.81
Fanduel,2022-08-23 23:21:00,Winnings,,31.0,1121.0,2871.81
Fanduel,2022-08-25 14:50:00,Winnings,Bonus,15.0,1136.0,2886.81
Fanduel,2022-08-28 11:59:00,Wager,,-15.0,1121.0,2871.81
Fanduel,2022-08-28 23:15:00,Winnings,,23.25,1144.25,2895.06
Fanduel,2022-09-01 16:42:00,Wager,,-25.0,1119.25,2870.06
Fanduel,2022-09-02 00:05:00,Winnings,Bonus,25.0,1144.25,2895.06
Draftkings,2022-09-03 10:22:00,Wager,,-10.0,684.0,2885.06
Draftkings,2022-09-03 10:24:00,Wager,,-7.0,677.0,2878.06
Draftkings,2022-09-03 21:54:00,Winnings,,28.5,705.5,2906.56
Draftkings,2022-09-03 21:57:00,Winnings,,9.25,714.75,2915.81
Draftkings,2022-09-03 23:23:00,Winnings,,25.04,748.81,2949.87
Draftkings,2022-09-03 23:23:00,Winnings,,9.02,723.77,2924.83
Draftkings,2022-09-04 00:05:00,Wager,,-20.0,728.81,2929.87
Fanduel,2022-09-04 23:46:00,Wager,,-50.0,1094.25,2879.87
Fanduel,2022-09-07 15:14:00,Wager,,-25.0,1069.25,2854.87
Draftkings,2022-09-08 18:57:00,Wager,,-10.0,718.81,2844.87
Draftkings,2022-09-08 19:21:00,Wager,,-1.81,717.0,2843.06
Fanduel,2022-09-08 20:09:00,Wager,,-3.25,1066.0,2839.81
Fanduel,2022-09-09 14:40:00,Winnings,Bonus,5.0,1071.0,2844.81
Draftkings,2022-09-09 18:51:00,Wager,,-5.0,712.0,2839.81
Draftkings,2022-09-09 18:56:00,Wager,,-12.0,700.0,2827.81
Draftkings,2022-09-09 18:57:00,Wager,,-3.0,697.0,2824.81
Draftkings,2022-09-09 22:12:00,Winnings,,5.6,702.6,2830.41
Draftkings,2022-09-09 22:13:00,Winnings,,0.66,703.26,2831.07
Draftkings,2022-09-10 16:45:00,Wager,,-10.0,693.26,2821.07
Draftkings,2022-09-10 16:48:00,Wager,,-5.0,688.26,2816.07
Draftkings,2022-09-10 16:52:00,Wager,,-5.26,683.0,2810.81
Draftkings,2022-09-10 16:53:00,Wager,,-3.0,680.0,2807.81
Fanduel,2022-09-10 17:58:00,Wager,,-25.0,1046.0,2782.81
Draftkings,2022-09-10 21:34:00,Winnings,,3.3,703.3,2806.11
Draftkings,2022-09-10 21:34:00,Winnings,,20.0,700.0,2802.81
Draftkings,2022-09-10 22:49:00,Winnings,,2.19,719.51,2822.32
Draftkings,2022-09-10 22:49:00,Winnings,,14.02,717.32,2820.13
Fanduel,2022-09-10 23:18:00,Wager,,-5.0,1041.0,2815.13
Draftkings,2022-09-11 11:22:00,Wager,,-5.0,714.51,2812.32
Draftkings,2022-09-11 15:45:00,Winnings,,5.0,719.51,2817.32
Fanduel,2022-09-11 16:12:00,Winnings,Bonus,25.0,1066.0,2842.32
Draftkings,2022-09-11 18:39:00,Wager,,-1.51,718.0,2840.81
Draftkings,2022-09-11 18:42:00,Wager,,-8.0,710.0,2832.81
Fanduel,2022-09-11 19:21:00,Winnings,,50.0,1116.0,2882.81
Fanduel,2022-09-11 19:41:00,Wager,,-25.0,1091.0,2857.81
Draftkings,2022-09-12 18:30:00,Wager,,-10.0,700.0,2847.81
Fanduel,2022-09-12 19:31:00,Wager,,-1.0,1090.0,2846.81
Fanduel,2022-09-15 20:15:00,Wager,,-10.0,1080.0,2836.81
Fanduel,2022-09-15 23:14:00,Winnings,,50.6,1130.6,2887.41
Fanduel,2022-09-16 00:12:00,Wager,,-1.6,1129.0,2885.81
Draftkings,2022-09-17 16:19:00,Wager,,-15.0,685.0,2870.81
Draftkings,2022-09-17 16:22:00,Wager,,-10.0,675.0,2860.81
Fanduel,2022-09-17 17:10:00,Wager,,-10.0,1119.0,2850.81
Fanduel,2022-09-17 17:14:00,Wager,,-20.0,1099.0,2830.81
Draftkings,2022-09-17 17:18:00,Winnings,,10.0,685.0,2840.81
Fanduel,2022-09-17 17:28:00,Wager,,-1.0,1098.0,2839.81
Fanduel,2022-09-18 02:11:00,Winnings,Bonus,10.0,1209.65,2951.46
Fanduel,2022-09-18 02:11:00,Winnings,,101.65,1199.65,2941.46
Draftkings,2022-09-18 11:04:00,Wager,,-3.0,682.0,2938.46
Fanduel,2022-09-18 13:54:00,Wager,,-10.0,1199.65,2938.46
Fanduel,2022-09-18 16:15:00,Winnings,Bonus,10.0,1209.65,2948.46
Fanduel,2022-09-18 20:35:00,Winnings,,17.64,1227.29,2966.1
Draftkings,2022-09-19 18:09:00,Wager,,-7.0,675.0,2959.1
Draftkings,2022-09-19 18:11:00,Wager,,-2.0,673.0,2957.1
Fanduel,2022-09-19 19:09:00,Wager,,-10.0,1217.29,2947.1
Draftkings,2022-09-19 23:59:00,Winnings,,24.81,697.81,2971.91
Draftkings,2022-09-19 23:59:00,Winnings,,5.6,703.41,2977.51
Fanduel,2022-09-20 11:50:00,Winnings,Bonus,5.0,1222.29,2982.51
Draftkings,2022-09-22 11:22:00,Wager,,-10.0,693.41,2972.51
Draftkings,2022-09-22 11:28:00,Wager,,-10.0,683.41,2962.51
Draftkings,2022-09-22 11:36:00,Wager,,-6.41,677.0,2956.1
Fanduel,2022-09-22 12:16:00,Wager,,-10.0,1212.29,2946.1
Fanduel,2022-09-22 12:20:00,Wager,,-5.0,1207.29,2941.1
Draftkings,2022-09-22 19:43:00,Winnings,,15.55,692.55,2956.65
Fanduel,2022-09-22 23:30:00,Winnings,Bonus,10.0,1217.29,2966.65
Fanduel,2022-09-23 00:18:00,Wager,,-20.0,1197.29,2946.65
Fanduel,2022-09-23 19:21:00,Wager,,-20.0,1177.29,2926.65
Fanduel,2022-09-24 18:51:00,Winnings,Bonus,10.0,1187.29,2936.65
Fanduel,2022-09-24 20:54:00,Wager,,-10.0,1177.29,2926.65
Fanduel,2022-09-24 22:58:00,Winnings,,18.7,1195.99,2945.35
Draftkings,2022-09-25 09:53:00,Wager,,-10.0,682.55,2935.35
Draftkings,2022-09-25 09:54:00,Wager,,-1.55,681.0,2933.8
Draftkings,2022-09-25 09:58:00,Wager,,-2.0,679.0,2931.8
Fanduel,2022-09-25 12:13:00,Wager,,-10.0,1185.99,2921.8
Fanduel,2022-09-25 13:09:00,Winnings,,21.5,1207.49,2943.3
Draftkings,2022-09-25 15:48:00,Winnings,,29.5,708.5,2972.8
Draftkings,2022-09-25 15:48:00,Winnings,,9.75,718.25,2982.55
Fanduel,2022-09-25 16:19:00,Winnings,Bonus,20.0,1227.49,3002.55
Fanduel,2022-09-25 17:51:00,Wager,,-10.0,1217.49,2992.55
Fanduel,2022-09-25 19:42:00,Winnings,,35.0,1252.49,3027.55
Draftkings,2022-09-26 15:53:00,Wager,,-7.0,711.25,3020.55
Draftkings,2022-09-26 16:03:00,Wager,,-7.25,704.0,3013.3
Draftkings,2022-09-26 21:18:00,Winnings,,9.8,713.8,3023.1
Draftkings,2022-09-26 21:21:00,Winnings,,4.2,718.0,3027.3
Draftkings,2022-09-26 21:24:00,Wager,,-3.0,715.0,3024.3
Draftkings,2022-09-29 18:15:00,Wager,,-5.0,710.0,3019.3
Draftkings,2022-09-29 18:16:00,Wager,,-10.0,700.0,3009.3
Draftkings,2022-09-29 18:16:00,Winnings,,10.0,710.0,3019.3
Draftkings,2022-09-29 18:16:00,Wager,,-10.0,700.0,3009.3
Draftkings,2022-09-29 18:58:00,Wager,,-10.0,690.0,2999.3
Fanduel,2022-09-29 19:53:00,Wager,,-20.0,1232.49,2979.3
Fanduel,2022-09-29 20:14:00,Wager,,-4.49,1228.0,2974.81
Draftkings,2022-09-29 22:41:00,Winnings,,45.0,735.0,3019.81
Draftkings,2022-09-29 22:41:00,Winnings,,10.5,745.5,3030.31
Fanduel,2022-09-29 23:26:00,Winnings,Bonus,20.0,1248.0,3050.31
Draftkings,2022-10-01 11:08:00,Wager,,-4.5,741.0,3045.81
Fanduel,2022-10-01 11:44:00,Wager,,-5.0,1243.0,3040.81
Fanduel,2022-10-01 11:49:00,Wager,,-3.0,1240.0,3037.81
Fanduel,2022-10-01 11:53:00,Wager,,-5.0,1235.0,3032.81
Fanduel,2022-10-01 12:06:00,Wager,,-5.0,1230.0,3027.81
Fanduel,2022-10-01 12:52:00,Wager,,-20.0,1210.0,3007.81
Fanduel,2022-10-01 13:15:00,Wager,,-20.0,1190.0,2987.81
Fanduel,2022-10-01 19:33:00,Winnings,Bonus,5.0,1195.0,2992.81
Fanduel,2022-10-01 21:38:00,Wager,,-4.0,1191.0,2988.81
Draftkings,2022-10-01 22:28:00,Winnings,,12.6,753.6,3001.41
Draftkings,2022-10-01 22:29:00,Winnings,,2.67,756.27,3004.08
Fanduel,2022-10-02 01:49:00,Winnings,,16.64,1207.64,3020.72
Fanduel,2022-10-02 01:50:00,Winnings,Bonus,5.0,1212.64,3025.72
Fanduel,2022-10-02 02:53:00,Winnings,Bonus,5.0,1217.64,3030.72
Fanduel,2022-10-02 02:53:00,Winnings,Bonus,4.0,1221.64,3034.72
Fanduel,2022-10-02 10:30:00,Wager,,-20.0,1201.64,3014.72
Draftkings,2022-10-02 11:56:00,Wager,,-1.27,755.0,3013.45
Draftkings,2022-10-02 11:59:00,Wager,,-4.0,751.0,3009.45
Fanduel,2022-10-02 12:37:00,Winnings,Bonus,20.0,1221.64,3029.45
Fanduel,2022-10-02 15:56:00,Wager,,-19.0,1202.64,3010.45
Fanduel,2022-10-02 15:56:00,Wager,,-20.0,1182.64,2990.45
Fanduel,2022-10-02 19:13:00,Winnings,,45.6,1228.24,3036.05
Draftkings,2022-10-02 19:19:00,Wager,,-3.0,748.0,3033.05
Fanduel,2022-10-02 20:18:00,Wager,,-5.24,1223.0,3027.81
Draftkings,2022-10-02 20:55:00,Wager,,-2.0,746.0,3025.81
Fanduel,2022-10-02 23:29:00,Winnings,,14.15,1237.15,3039.96
Fanduel,2022-10-02 23:29:00,Winnings,,30.0,1267.15,3069.96
Fanduel,2022-10-03 13:02:00,Winnings,Bonus,5.0,1272.15,3074.96
Draftkings,2022-10-03 16:58:00,Wager,,-5.0,741.0,3069.96
Draftkings,2022-10-03 17:02:00,Wager,,-6.0,735.0,3063.96
Draftkings,2022-10-06 13:54:00,Wager,,-1.0,729.0,3057.96
Fanduel,2022-10-06 14:04:00,Wager,,-20.0,1252.15,3037.96
Draftkings,2022-10-06 19:42:00,Winnings,,14.44,743.44,3052.4
Draftkings,2022-10-06 19:43:00,Winnings,,5.56,749.0,3057.96
Draftkings,2022-10-06 21:15:00,Wager,,-1.0,748.0,3056.96
Fanduel,2022-10-06 23:50:00,Winnings,Bonus,20.0,1272.15,3076.96
Draftkings,2022-10-07 11:01:00,Wager,,-5.0,743.0,3071.96
Fanduel,2022-10-07 11:43:00,Wager,,-7.0,1265.15,3064.96
Fanduel,2022-10-07 11:44:00,Winnings,,7.0,1272.15,3071.96
Fanduel,2022-10-07 11:45:00,Wager,,-7.0,1265.15,3064.96
Fanduel,2022-10-07 11:48:00,Wager,,-7.0,1258.15,3057.96
Fanduel,2022-10-07 11:52:00,Wager,,-5.0,1253.15,3052.96
Fanduel,2022-10-07 11:58:00,Wager,,-5.0,1248.15,3047.96
Fanduel,2022-10-07 13:53:00,Winnings,Bonus,20.0,1268.15,3067.96
Draftkings,2022-10-07 17:45:00,Wager,,-3.0,740.0,3064.96
Draftkings,2022-10-07 17:46:00,Wager,,-7.0,733.0,3057.96
Draftkings,2022-10-07 17:47:00,Wager,,-1.0,732.0,3056.96
Draftkings,2022-10-07 21:07:00,Wager,,-3.0,729.0,3053.96
Fanduel,2022-10-07 22:10:00,Wager,,-5.0,1243.15,3028.96
Fanduel,2022-10-07 22:10:00,Wager,,-20.0,1248.15,3033.96
Fanduel,2022-10-07 23:13:00,Winnings,Bonus,5.0,1255.15,3040.96
Fanduel,2022-10-07 23:13:00,Winnings,Bonus,7.0,1250.15,3035.96
Fanduel,2022-10-08 11:58:00,Wager,,-6.0,1249.15,3034.96
Fanduel,2022-10-08 12:00:00,Wager,,-5.0,1244.15,3029.96
Fanduel,2022-10-08 12:02:00,Wager,,-6.0,1238.15,3023.96
Fanduel,2022-10-08 13:48:00,Wager,,-5.0,1233.15,3018.96
Fanduel,2022-10-08 18:04:00,Winnings,Bonus,6.0,1239.15,3024.96
Fanduel,2022-10-08 23:20:00,Winnings,Bonus,5.0,1244.15,3029.96
Fanduel,2022-10-09 00:30:00,Winnings,Bonus,6.0,1250.15,3035.96
Draftkings,2022-10-09 11:44:00,Wager,,-2.0,727.0,3033.96
Draftkings,2022-10-09 11:47:00,Wager,,-8.0,719.0,3025.96
Draftkings,2022-10-09 11:49:00,Wager,,-1.0,718.0,3024.96
Fanduel,2022-10-09 11:50:00,Wager,,-12.0,1238.15,3012.96
Fanduel,2022-10-09 11:55:00,Wager,,-20.0,1218.15,2992.96
Fanduel,2022-10-09 11:55:00,Wager,,-17.0,1201.15,2975.96
Draftkings,2022-10-09 11:56:00,Wager,,-4.0,714.0,2971.96
Fanduel,2022-10-09 12:02:00,Wager,,-10.0,1191.15,2961.96
Fanduel,2022-10-09 12:03:00,Wager,,-4.15,1187.0,2957.81
Draftkings,2022-10-09 12:07:00,Winnings,,5.22,719.22,2963.03
Draftkings,2022-10-09 12:08:00,Winnings,,1.38,720.6,2964.41
Fanduel,2022-10-09 12:16:00,Wager,,-8.0,1179.0,2956.41
Draftkings,2022-10-09 15:16:00,Wager,,-1.6,719.0,2954.81
Draftkings,2022-10-09 15:28:00,Winnings,,3.76,736.16,2971.97
Draftkings,2022-10-09 15:28:00,Winnings,,13.4,732.4,2968.21
Fanduel,2022-10-09 16:07:00,Winnings,,18.0,1197.0,2986.21
Fanduel,2022-10-09 19:19:00,Winnings,Bonus,10.0,1207.0,2996.21
Fanduel,2022-10-09 20:04:00,Wager,,-10.0,1197.0,2986.21
Fanduel,2022-10-09 20:04:00,Wager,,-2.0,1195.0,2984.21
Fanduel,2022-10-09 20:36:00,Winnings,,34.0,1229.0,3018.21
Fanduel,2022-10-10 12:43:00,Winnings,Bonus,5.0,1234.0,3023.21
Draftkings,2022-10-10 18:56:00,Wager,,-6.16,730.0,3020.81
Fanduel,2022-10-10 19:52:00,Wager,,-5.0,1229.0,3015.81
Fanduel,2022-10-10 19:53:00,Wager,,-9.0,1220.0,3006.81
Draftkings,2022-10-10 20:51:00,Wager,,-5.0,725.0,3001.81
Draftkings,2022-10-11 12:29:00,Wager,,-2.0,723.0,2999.81
Draftkings,2022-10-11 12:38:00,Wager,,-10.0,713.0,2989.81
Draftkings,2022-10-11 12:40:00,Wager,,-5.0,708.0,2984.81
Draftkings,2022-10-11 21:08:00,Winnings,,15.75,723.75,3000.56
Draftkings,2022-10-11 21:08:00,Winnings,,3.54,727.29,3004.1
Draftkings,2022-10-12 10:06:00,Wager,,-3.0,724.29,3001.1
Draftkings,2022-10-12 19:30:00,Wager,,-3.0,721.29,2998.1
Draftkings,2022-10-12 19:32:00,Wager,,-6.29,715.0,2991.81
Fanduel,2022-10-12 23:58:00,Wager,,-10.0,1210.0,2981.81
Draftkings,2022-10-13 17:34:00,Wager,,-25.0,690.0,2956.81
Draftkings,2022-10-13 17:53:00,Wager,,-6.0,684.0,2950.81
Draftkings,2022-10-13 18:16:00,Wager,,-20.0,664.0,2930.81
Draftkings,2022-10-13 21:09:00,Wager,,-10.0,654.0,2920.81
Draftkings,2022-10-13 22:07:00,Winnings,,45.83,699.83,2966.64
Draftkings,2022-10-13 22:08:00,Winnings,,18.0,717.83,2984.64
Fanduel,2022-10-13 23:34:00,Winnings,,50.19,1260.19,3034.83
Draftkings,2022-10-14 14:25:00,Wager,,-10.0,707.83,3024.83
Fanduel,2022-10-15 11:49:00,Wager,,-2.0,1258.19,3022.83
Fanduel,2022-10-15 18:19:00,Wager,,-4.0,1254.19,3018.83
Fanduel,2022-10-15 19:38:00,Winnings,,10.39,1264.58,3029.22
Fanduel,2022-10-16 00:31:00,Winnings,Bonus,4.0,1268.58,3033.22
Draftkings,2022-10-16 11:20:00,Wager,,-5.0,702.83,3028.22
Draftkings,2022-10-16 11:21:00,Wager,,-5.83,697.0,3022.39
Draftkings,2022-10-16 11:22:00,Wager,,-7.0,690.0,3015.39
Fanduel,2022-10-16 11:23:00,Wager,,-8.0,1260.58,3007.39
Fanduel,2022-10-16 11:25:00,Wager,,-6.58,1254.0,3000.81
Fanduel,2022-10-16 12:18:00,Wager,,-10.0,1244.0,2990.81
Fanduel,2022-10-16 12:19:00,Wager,,-4.0,1240.0,2986.81
Draftkings,2022-10-16 15:13:00,Winnings,,20.44,710.44,3007.25
Draftkings,2022-10-16 15:33:00,Wager,,-10.44,700.0,2996.81
Fanduel,2022-10-16 16:27:00,Winnings,,50.85,1290.85,3047.66
Fanduel,2022-10-16 16:27:00,Winnings,Bonus,10.0,1300.85,3057.66
Draftkings,2022-10-16 16:28:00,Wager,,-1.5,698.5,3056.16
Fanduel,2022-10-16 16:47:00,Wager,,-8.85,1292.0,3047.31
Fanduel,2022-10-16 16:48:00,Wager,,-10.0,1282.0,3037.31
Fanduel,2022-10-16 17:26:00,Wager,,-3.0,1279.0,3034.31
Fanduel,2022-10-16 17:27:00,Wager,,-3.0,1276.0,3031.31
Fanduel,2022-10-16 19:36:00,Winnings,,18.94,1294.94,3050.25
Fanduel,2022-10-16 19:41:00,Winnings,,14.48,1309.42,3064.73
Fanduel,2022-10-16 20:05:00,Wager,,-6.42,1303.0,3058.31
Draftkings,2022-10-16 22:39:00,Winnings,,1.95,710.16,3069.97
Draftkings,2022-10-16 22:39:00,Winnings,,9.71,708.21,3068.02
Fanduel,2022-10-16 23:25:00,Winnings,,15.41,1318.41,3083.43
Fanduel,2022-10-16 23:30:00,Winnings,,25.0,1343.41,3108.43
Draftkings,2022-10-17 12:06:00,Wager,,-10.0,700.16,3100.38
Draftkings,2022-10-17 12:09:00,Wager,,-10.0,690.16,3090.38
Draftkings,2022-10-17 12:15:00,Wager,,-3.16,687.0,3087.22
Fanduel,2022-10-17 13:17:00,Wager,,-3.41,1335.0,3078.81
Fanduel,2022-10-17 13:17:00,Wager,,-5.0,1338.41,3082.22
Fanduel,2022-10-17 14:33:00,Winnings,Bonus,5.0,1340.0,3083.81
Draftkings,2022-10-17 20:50:00,Winnings,,10.0,697.0,3093.81
Draftkings,2022-10-17 20:58:00,Winnings,,3.16,700.16,3096.97
Fanduel,2022-10-17 23:35:00,Winnings,,15.0,1355.0,3111.97
Draftkings,2022-10-18 21:30:00,Wager,,-10.0,690.16,3101.97
Draftkings,2022-10-19 19:56:00,Wager,,-3.13,687.03,3098.84
Draftkings,2022-10-19 19:58:00,Wager,,-6.0,681.03,3092.84
Draftkings,2022-10-19 20:01:00,Wager,,-10.0,671.03,3082.84
Draftkings,2022-10-19 20:18:00,Winnings,,11.0,682.03,3093.84
Draftkings,2022-10-19 20:22:00,Winnings,,9.0,691.03,3102.84
Fanduel,2022-10-19 20:23:00,Wager,,-20.0,1335.0,3082.84
Draftkings,2022-10-19 21:07:00,Winnings,,9.39,700.42,3092.23
Draftkings,2022-10-19 21:08:00,Winnings,,2.06,702.48,3094.29
Fanduel,2022-10-20 00:42:00,Winnings,,102.28,1437.28,3196.57
Draftkings,2022-10-20 17:12:00,Wager,,-10.0,692.48,3186.57
Draftkings,2022-10-20 17:13:00,Wager,,-0.48,692.0,3186.09
Draftkings,2022-10-20 17:16:00,Wager,,-7.0,685.0,3179.09
Fanduel,2022-10-20 18:04:00,Wager,,-10.0,1427.28,3169.09
Fanduel,2022-10-20 18:17:00,Wager,,-7.28,1420.0,3161.81
Fanduel,2022-10-20 20:16:00,Wager,,-3.0,1417.0,3158.81
Fanduel,2022-10-20 22:16:00,Wager,,-6.0,1411.0,3152.81
Fanduel,2022-10-20 22:59:00,Winnings,,11.31,1422.31,3164.12
Fanduel,2022-10-20 23:34:00,Winnings,Bonus,10.0,1432.31,3174.12
Draftkings,2022-10-21 12:04:00,Wager,,-10.0,675.0,3164.12
Draftkings,2022-10-21 12:06:00,Wager,,-10.0,665.0,3154.12
Draftkings,2022-10-21 12:07:00,Wager,,-3.0,662.0,3151.12
Draftkings,2022-10-21 18:42:00,Wager,,-4.0,658.0,3147.12
Draftkings,2022-10-21 19:56:00,Winnings,,16.06,674.06,3163.18
Draftkings,2022-10-21 19:56:00,Winnings,,3.03,677.09,3166.21
Draftkings,2022-10-21 22:40:00,Winnings,,30.5,707.59,3196.71
Draftkings,2022-10-21 22:40:00,Winnings,,12.3,719.89,3209.01
Draftkings,2022-10-22 14:38:00,Winnings,,8.0,727.89,3217.01
Draftkings,2022-10-22 14:38:00,Winnings,,1.0,728.89,3218.01
Draftkings,2022-10-22 16:41:00,Wager,,-8.89,720.0,3209.12
Draftkings,2022-10-22 16:53:00,Wager,,-7.0,713.0,3202.12
Draftkings,2022-10-22 16:57:00,Wager,,-10.0,703.0,3192.12
Draftkings,2022-10-22 17:25:00,Wager,,-10.0,693.0,3182.12
Fanduel,2022-10-22 17:39:00,Wager,,-5.0,1427.31,3177.12
Draftkings,2022-10-22 22:05:00,Winnings,,16.97,709.97,3194.09
Draftkings,2022-10-22 22:05:00,Winnings,,2.02,711.99,3196.11
Draftkings,2022-10-22 23:11:00,Wager,,-6.99,705.0,3189.12
Draftkings,2022-10-23 00:51:00,Winnings,,13.34,718.34,3202.46
Draftkings,2022-10-23 00:51:00,Winnings,,3.18,721.52,3205.64
Fanduel,2022-10-23 01:52:00,Winnings,Bonus,5.0,1432.31,3210.64
Draftkings,2022-10-23 12:01:00,Wager,,-21.52,700.0,3189.12
Draftkings,2022-10-23 12:09:00,Wager,,-6.0,694.0,3183.12
Fanduel,2022-10-23 12:47:00,Wager,,-5.0,1427.31,3178.12
Fanduel,2022-10-23 12:51:00,Wager,,-10.0,1412.31,3163.12
Fanduel,2022-10-23 12:51:00,Wager,,-5.0,1422.31,3173.12
Fanduel,2022-10-23 12:54:00,Wager,,-5.31,1407.0,3157.81
Draftkings,2022-10-23 16:10:00,Wager,,-4.0,690.0,3153.81
Draftkings,2022-10-23 18:03:00,Wager,,-4.0,686.0,3149.81
Draftkings,2022-10-23 18:33:00,Winnings,,55.49,741.49,3205.3
Draftkings,2022-10-23 18:35:00,Winnings,,16.99,758.48,3222.29
Fanduel,2022-10-23 19:33:00,Winnings,,13.89,1420.89,3236.18
Fanduel,2022-10-23 19:38:00,Wager,,-8.89,1412.0,3227.29
Fanduel,2022-10-23 19:44:00,Wager,,-4.0,1408.0,3223.29
Draftkings,2022-10-23 21:45:00,Winnings,,11.11,769.59,3234.4
Draftkings,2022-10-23 21:47:00,Winnings,,2.89,772.48,3237.29
Fanduel,2022-10-23 23:33:00,Winnings,,23.11,1431.11,3260.4
Draftkings,2022-10-24 18:57:00,Wager,,-20.0,752.48,3240.4
Draftkings,2022-10-24 19:02:00,Wager,,-12.0,740.48,3228.4
Draftkings,2022-10-24 19:06:00,Wager,,-6.48,734.0,3221.92
Draftkings,2022-10-24 19:09:00,Wager,,-3.0,731.0,3218.92
Fanduel,2022-10-24 19:50:00,Wager,,-11.11,1420.0,3207.81
Draftkings,2022-10-24 22:40:00,Winnings,,8.7,739.7,3216.51
Draftkings,2022-10-24 22:40:00,Winnings,,4.56,744.26,3221.07
Fanduel,2022-10-24 23:27:00,Winnings,,22.22,1442.22,3243.29
Draftkings,2022-10-25 19:06:00,Wager,,-8.26,736.0,3235.03
Draftkings,2022-10-25 19:20:00,Wager,,-10.0,726.0,3225.03
Draftkings,2022-10-26 06:26:00,Winnings,,25.88,751.88,3250.91
Draftkings,2022-10-26 06:26:00,Winnings,,5.0,756.88,3255.91
Draftkings,2022-10-26 20:03:00,Wager,,-10.0,746.88,3245.91
Draftkings,2022-10-26 20:06:00,Wager,,-6.88,740.0,3239.03
Draftkings,2022-10-26 22:47:00,Wager,,-10.0,730.0,3229.03
Draftkings,2022-10-26 23:29:00,Winnings,,3.07,749.23,3248.26
Draftkings,2022-10-26 23:29:00,Winnings,,16.16,746.16,3245.19
Draftkings,2022-10-27 18:15:00,Wager,,-7.0,742.23,3241.26
Draftkings,2022-10-27 18:23:00,Wager,,-7.23,735.0,3234.03
Draftkings,2022-10-27 18:26:00,Wager,,-5.0,730.0,3229.03
Fanduel,2022-10-27 19:11:00,Wager,,-8.22,1434.0,3220.81
Fanduel,2022-10-27 19:13:00,Wager,,-10.0,1424.0,3210.81
Draftkings,2022-10-27 22:21:00,Winnings,,2.1,747.5,3228.31
Draftkings,2022-10-27 22:21:00,Winnings,,15.4,745.4,3226.21
Draftkings,2022-10-27 22:42:00,Winnings,,22.62,777.81,3258.62
Draftkings,2022-10-27 22:42:00,Winnings,,7.69,755.19,3236.0
Fanduel,2022-10-27 23:29:00,Winnings,Bonus,10.0,1434.0,3246.0
Fanduel,2022-10-28 00:01:00,Winnings,,20.55,1454.55,3266.55
Draftkings,2022-10-28 18:33:00,Wager,,-2.81,775.0,3286.36
Draftkings,2022-10-28 18:37:00,Wager,,-8.0,767.0,3278.36
Fanduel,2022-10-28 19:39:00,Wager,,-4.0,1450.55,3274.36
Fanduel,2022-10-28 23:34:00,Winnings,Bonus,4.0,1454.55,3278.36
Fanduel,2022-10-29 01:51:00,Wager,,-4.0,1450.55,3274.36
Fanduel,2022-10-29 01:54:00,Wager,,-5.0,1445.55,3269.36
Fanduel,2022-10-29 01:57:00,Wager,,-10.0,1435.55,3259.36
Fanduel,2022-10-29 01:59:00,Wager,,-4.0,1431.55,3255.36
Draftkings,2022-10-29 10:08:00,Wager,,-5.0,762.0,3250.36
Draftkings,2022-10-29 10:09:00,Wager,,-3.0,759.0,3247.36
Draftkings,2022-10-29 10:12:00,Wager,,-4.0,755.0,3243.36
Draftkings,2022-10-29 10:13:00,Wager,,-3.0,752.0,3240.36
Draftkings,2022-10-29 10:16:00,Wager,,-7.0,745.0,3233.36
Draftkings,2022-10-29 14:40:00,Winnings,,0.68,751.4,3239.76
Draftkings,2022-10-29 14:40:00,Winnings,,5.72,750.72,3239.08
Draftkings,2022-10-29 14:43:00,Wager,,-3.4,748.0,3236.36
Draftkings,2022-10-29 14:45:00,Wager,,-3.0,745.0,3233.36
Draftkings,2022-10-29 21:47:00,Winnings,,7.2,752.2,3240.56
Draftkings,2022-10-29 21:48:00,Winnings,,1.26,753.46,3241.82
Draftkings,2022-10-29 22:12:00,Winnings,,1.48,762.44,3250.8
Draftkings,2022-10-29 22:12:00,Winnings,,7.5,760.96,3249.32
Draftkings,2022-10-29 22:31:00,Winnings,,9.69,772.13,3260.49
Draftkings,2022-10-29 22:31:00,Winnings,,4.08,776.21,3264.57
Fanduel,2022-10-30 03:03:00,Wager,,-4.55,1427.0,3260.02
Draftkings,2022-10-30 10:39:00,Wager,,-3.21,773.0,3256.81
Draftkings,2022-10-30 10:40:00,Wager,,-2.0,771.0,3254.81
Draftkings,2022-10-30 10:43:00,Wager,,-5.0,766.0,3249.81
Draftkings,2022-10-30 10:53:00,Wager,,-10.0,756.0,3239.81
Draftkings,2022-10-30 10:57:00,Wager,,-6.0,750.0,3233.81
Draftkings,2022-10-30 11:03:00,Wager,,-3.0,747.0,3230.81
Fanduel,2022-10-30 12:03:00,Wager,,-6.0,1421.0,3224.81
Fanduel,2022-10-30 12:05:00,Wager,,-4.0,1417.0,3220.81
Fanduel,2022-10-30 12:06:00,Wager,,-5.0,1412.0,3215.81
Fanduel,2022-10-30 12:07:00,Wager,,-5.0,1407.0,3210.81
Fanduel,2022-10-30 12:30:00,Winnings,,9.56,1416.56,3220.37
Fanduel,2022-10-30 13:26:00,Wager,,-8.0,1408.56,3212.37
Fanduel,2022-10-30 14:22:00,Winnings,,9.17,1417.73,3221.54
Fanduel,2022-10-30 15:39:00,Winnings,,8.0,1425.73,3229.54
Fanduel,2022-10-30 16:11:00,Winnings,,14.25,1439.98,3243.79
Draftkings,2022-10-30 18:11:00,Winnings,,35.86,782.86,3279.65
Draftkings,2022-10-30 18:12:00,Winnings,,12.94,795.8,3292.59
Fanduel,2022-10-30 19:17:00,Wager,,-10.0,1429.98,3282.59
Fanduel,2022-10-30 19:27:00,Winnings,,12.17,1442.15,3294.76
Fanduel,2022-10-30 19:29:00,Winnings,,12.0,1454.15,3306.76
Draftkings,2022-10-30 22:33:00,Winnings,,2.57,813.65,3324.61
Draftkings,2022-10-30 22:33:00,Winnings,,15.28,811.08,3322.04
Fanduel,2022-10-30 23:29:00,Winnings,,22.0,1476.15,3344.04
Fanduel,2022-10-31 12:14:00,Winnings,Bonus,5.0,1481.15,3349.04
Draftkings,2022-10-31 18:48:00,Wager,,-5.0,808.65,3346.61
Draftkings,2022-10-31 18:49:00,Wager,,-5.0,803.65,3341.61
Draftkings,2022-10-31 18:50:00,Wager,,-5.0,803.65,3341.61
Draftkings,2022-10-31 18:50:00,Wager,,5.0,808.65,3346.61
Draftkings,2022-10-31 18:50:00,Wager,,-5.0,803.65,3341.61
Draftkings,2022-10-31 18:50:00,Wager,,5.0,808.65,3346.61
Draftkings,2022-10-31 18:50:00,Wager,,5.0,808.65,3346.61
Draftkings,2022-10-31 18:51:00,Wager,,-5.0,803.65,3341.61
Draftkings,2022-10-31 18:54:00,Wager,,-3.65,800.0,3337.96
Fanduel,2022-10-31 19:40:00,Wager,,-8.15,1473.0,3329.81
Draftkings,2022-10-31 21:01:00,Winnings,,9.54,809.54,3339.35
Draftkings,2022-10-31 21:02:00,Winnings,,1.5,811.04,3340.85
Draftkings,2022-10-31 21:49:00,Winnings,,8.76,819.8,3349.61
Draftkings,2022-10-31 21:50:00,Winnings,,3.32,823.12,3352.93
Draftkings,2022-10-31 22:36:00,Winnings,,7.0,842.12,3371.93
Draftkings,2022-10-31 22:36:00,Winnings,,12.0,835.12,3364.93
Draftkings,2022-11-01 18:54:00,Wager,,-6.12,836.0,3365.81
Draftkings,2022-11-01 18:55:00,Wager,,-6.0,830.0,3359.81
Draftkings,2022-11-01 19:02:00,Wager,,-10.0,820.0,3349.81
Draftkings,2022-11-01 19:11:00,Wager,,-7.0,813.0,3342.81
Draftkings,2022-11-01 19:12:00,Wager,,-3.0,810.0,3339.81
Fanduel,2022-11-01 20:06:00,Wager,,-5.0,1468.0,3334.81
Fanduel,2022-11-01 20:09:00,Wager,,-6.0,1462.0,3328.81
Draftkings,2022-11-01 21:36:00,Wager,,-4.0,806.0,3324.81
Draftkings,2022-11-01 22:12:00,Winnings,,17.1,823.1,3341.91
Draftkings,2022-11-01 22:12:00,Winnings,,2.77,825.87,3344.68
Draftkings,2022-11-02 00:20:00,Winnings,,2.53,844.61,3363.42
Draftkings,2022-11-02 00:20:00,Winnings,,16.21,842.08,3360.89
Fanduel,2022-11-02 00:38:00,Winnings,,26.77,1488.77,3387.66
Draftkings,2022-11-02 19:01:00,Wager,,-5.0,839.61,3385.19
Draftkings,2022-11-02 19:06:00,Wager,,-10.0,829.61,3375.19
Draftkings,2022-11-02 19:10:00,Wager,,-3.61,826.0,3371.58
Fanduel,2022-11-02 20:11:00,Wager,,-3.77,1485.0,3367.81
Draftkings,2022-11-03 18:16:00,Wager,,-10.0,816.0,3357.81
Draftkings,2022-11-03 18:17:00,Wager,,-6.0,810.0,3351.81
Draftkings,2022-11-03 18:18:00,Wager,,-11.0,799.0,3340.81
Draftkings,2022-11-03 18:25:00,Wager,,-7.0,792.0,3333.81
Draftkings,2022-11-03 18:27:00,Wager,,-2.0,790.0,3331.81
Fanduel,2022-11-03 19:07:00,Wager,,-5.0,1475.0,3321.81
Fanduel,2022-11-03 19:07:00,Wager,,-5.0,1480.0,3326.81
Fanduel,2022-11-03 19:07:00,Wager,,-1.0,1474.0,3320.81
Fanduel,2022-11-03 19:11:00,Wager,,-4.0,1470.0,3316.81
Fanduel,2022-11-03 20:24:00,Winnings,Bonus,5.0,1475.0,3321.81
Draftkings,2022-11-03 21:33:00,Winnings,,10.13,800.13,3331.94
Draftkings,2022-11-03 21:34:00,Winnings,,1.87,802.0,3333.81
Fanduel,2022-11-03 22:39:00,Winnings,,10.81,1485.81,3344.62
Draftkings,2022-11-03 23:51:00,Winnings,,4.9,806.9,3349.52
Draftkings,2022-11-03 23:51:00,Winnings,,0.87,807.77,3350.39
Fanduel,2022-11-04 10:38:00,Wager,,-20.0,1465.81,3330.39
Fanduel,2022-11-04 10:39:00,Wager,,-3.0,1462.81,3327.39
Draftkings,2022-11-04 18:23:00,Wager,,-3.77,804.0,3323.62
Fanduel,2022-11-05 12:08:00,Wager,,-6.81,1456.0,3316.81
Fanduel,2022-11-05 12:12:00,Wager,,-20.0,1436.0,3296.81
Fanduel,2022-11-05 12:14:00,Wager,,-10.0,1426.0,3286.81
Draftkings,2022-11-05 14:36:00,Wager,,-10.0,794.0,3276.81
Draftkings,2022-11-05 14:37:00,Wager,,-5.0,789.0,3271.81
Draftkings,2022-11-05 20:43:00,Wager,,-6.0,783.0,3265.81
Fanduel,2022-11-06 01:22:00,Winnings,Bonus,10.0,1436.0,3275.81
Draftkings,2022-11-06 09:44:00,Wager,,-8.0,775.0,3267.81
Draftkings,2022-11-06 09:45:00,Wager,,-2.0,773.0,3265.81
Fanduel,2022-11-06 10:30:00,Wager,,-10.0,1426.0,3255.81
Fanduel,2022-11-06 10:34:00,Wager,,-8.0,1418.0,3247.81
Fanduel,2022-11-06 10:47:00,Wager,,-5.0,1413.0,3242.81
Fanduel,2022-11-06 11:24:00,Wager,,-6.0,1415.41,3245.22
Fanduel,2022-11-06 11:24:00,Winnings,,8.41,1421.41,3251.22
Fanduel,2022-11-06 11:25:00,Wager,,-2.41,1413.0,3242.81
Fanduel,2022-11-06 14:24:00,Winnings,,14.06,1427.06,3256.87
Draftkings,2022-11-06 14:58:00,Winnings,,15.62,788.62,3272.49
Fanduel,2022-11-06 16:10:00,Winnings,,11.73,1438.79,3284.22
Draftkings,2022-11-06 16:24:00,Wager,,-20.0,768.62,3264.22
Fanduel,2022-11-06 16:30:00,Winnings,,21.0,1459.79,3285.22
Fanduel,2022-11-06 20:17:00,Wager,,-8.0,1451.79,3277.22
Draftkings,2022-11-06 21:57:00,Winnings,,27.69,796.31,3304.91
Draftkings,2022-11-06 21:59:00,Winnings,,12.31,808.62,3317.22
Draftkings,2022-11-07 18:56:00,Wager,,-15.0,793.62,3302.22
Draftkings,2022-11-07 19:00:00,Wager,,-5.0,788.62,3297.22
Draftkings,2022-11-07 19:01:00,Wager,,-1.62,787.0,3295.6
Draftkings,2022-11-07 19:06:00,Wager,,-6.0,781.0,3289.6
Fanduel,2022-11-07 20:07:00,Wager,,-3.79,1448.0,3285.81
Draftkings,2022-11-07 22:25:00,Winnings,,6.25,798.5,3303.31
Draftkings,2022-11-07 22:25:00,Winnings,,11.25,792.25,3297.06
Fanduel,2022-11-07 23:07:00,Winnings,,26.83,1474.83,3323.89
Draftkings,2022-11-08 21:14:00,Wager,,-20.0,778.5,3310.14
Draftkings,2022-11-08 21:16:00,Wager,,-11.5,767.0,3298.64
Draftkings,2022-11-08 21:18:00,Wager,,-4.0,763.0,3294.64
Draftkings,2022-11-09 18:34:00,Wager,,-10.0,753.0,3284.64
Fanduel,2022-11-09 19:19:00,Wager,,-3.83,1471.0,3280.81
Draftkings,2022-11-09 20:30:00,Winnings,,8.16,788.98,3316.79
Draftkings,2022-11-09 20:30:00,Winnings,,27.82,780.82,3308.63
Draftkings,2022-11-10 16:57:00,Wager,,-4.98,784.0,3311.81
Draftkings,2022-11-10 17:01:00,Wager,,-10.0,774.0,3301.81
Draftkings,2022-11-10 17:02:00,Wager,,-4.0,770.0,3297.81
Fanduel,2022-11-10 17:56:00,Wager,,-5.0,1466.0,3292.81
Fanduel,2022-11-10 21:31:00,Winnings,Bonus,5.0,1471.0,3297.81
Draftkings,2022-11-11 17:49:00,Wager,,-7.0,763.0,3290.81
Draftkings,2022-11-11 17:51:00,Wager,,-3.0,750.0,3277.81
Draftkings,2022-11-11 17:51:00,Wager,,-10.0,753.0,3280.81
Draftkings,2022-11-11 17:55:00,Wager,,-4.0,746.0,3273.81
Fanduel,2022-11-11 18:47:00,Wager,,-3.0,1468.0,3270.81
Draftkings,2022-11-11 23:31:00,Winnings,,10.5,756.5,3281.31
Draftkings,2022-11-11 23:32:00,Winnings,,3.5,760.0,3284.81
Draftkings,2022-11-11 23:36:00,Winnings,,15.26,775.26,3300.07
Draftkings,2022-11-11 23:36:00,Winnings,,2.63,777.89,3302.7
Fanduel,2022-11-12 00:43:00,Wager,,-20.0,1448.0,3282.7
Fanduel,2022-11-12 00:46:00,Wager,,-1.0,1447.0,3281.7
Fanduel,2022-11-12 00:53:00,Winnings,,2.62,1449.62,3284.32
Fanduel,2022-11-12 00:57:00,Winnings,,13.5,1463.12,3297.82
Draftkings,2022-11-12 14:48:00,Wager,,-7.0,770.89,3290.82
Draftkings,2022-11-12 14:49:00,Wager,,-3.89,767.0,3286.93
Fanduel,2022-11-12 19:03:00,Winnings,Bonus,10.0,1473.12,3296.93
Draftkings,2022-11-12 22:00:00,Winnings,,9.53,776.53,3306.46
Draftkings,2022-11-13 02:05:00,Winnings,,1.41,777.94,3307.87
Draftkings,2022-11-13 11:38:00,Wager,,-5.94,772.0,3301.93
Draftkings,2022-11-13 11:40:00,Wager,,-2.0,770.0,3299.93
Draftkings,2022-11-13 11:47:00,Wager,,-6.0,764.0,3293.93
Fanduel,2022-11-13 12:32:00,Wager,,-5.0,1468.12,3288.93
Fanduel,2022-11-13 12:36:00,Wager,,-10.0,1458.12,3278.93
Fanduel,2022-11-13 12:37:00,Wager,,-8.12,1450.0,3270.81
Fanduel,2022-11-13 20:16:00,Winnings,,22.33,1472.33,3293.14
Fanduel,2022-11-14 20:08:00,Wager,,-5.33,1467.0,3287.81
Draftkings,2022-11-15 18:56:00,Wager,,-10.0,754.0,3277.81
Draftkings,2022-11-15 18:58:00,Wager,,-14.0,740.0,3263.81
Draftkings,2022-11-15 19:01:00,Wager,,-4.0,736.0,3259.81
Draftkings,2022-11-15 19:08:00,Wager,,-3.0,733.0,3256.81
Fanduel,2022-11-15 20:06:00,Wager,,-5.0,1462.0,3251.81
Draftkings,2022-11-15 23:23:00,Winnings,,32.2,765.2,3284.01
Draftkings,2022-11-15 23:23:00,Winnings,,9.1,774.3,3293.11
Fanduel,2022-11-16 00:25:00,Winnings,Bonus,5.0,1467.0,3298.11
Draftkings,2022-11-16 18:11:00,Wager,,-10.0,764.3,3288.11
Draftkings,2022-11-17 19:13:00,Wager,,-5.0,759.3,3283.11
Draftkings,2022-11-17 19:17:00,Wager,,6.0,759.3,3283.11
Draftkings,2022-11-17 19:17:00,Wager,,-6.0,753.3,3277.11
Draftkings,2022-11-17 19:17:00,Wager,,-6.0,753.3,3277.11
Fanduel,2022-11-17 20:13:00,Wager,,-5.0,1462.0,3272.11
Draftkings,2022-11-17 20:29:00,Winnings,,8.44,761.74,3280.55
Draftkings,2022-11-17 20:30:00,Winnings,,1.56,763.3,3282.11
Fanduel,2022-11-17 21:47:00,Wager,,-3.0,1459.0,3279.11
Fanduel,2022-11-17 21:52:00,Wager,,-4.0,1455.0,3275.11
Draftkings,2022-11-17 22:52:00,Wager,,-7.3,756.0,3267.81
Fanduel,2022-11-17 23:18:00,Winnings,Bonus,5.0,1460.0,3272.81
Fanduel,2022-11-18 18:40:00,Wager,,-5.0,1455.0,3267.81
Fanduel,2022-11-18 22:50:00,Winnings,,10.0,1465.0,3277.81
Draftkings,2022-11-19 10:59:00,Wager,,-7.0,749.0,3270.81
Draftkings,2022-11-19 11:03:00,Wager,,-15.0,734.0,3255.81
Draftkings,2022-11-19 11:05:00,Wager,,-15.0,719.0,3240.81
Fanduel,2022-11-19 11:53:00,Wager,,-5.0,1460.0,3235.81
Fanduel,2022-11-19 11:56:00,Wager,,-20.0,1440.0,3215.81
Fanduel,2022-11-19 19:20:00,Winnings,Bonus,10.0,1450.0,3225.81
Draftkings,2022-11-19 22:06:00,Wager,,-7.0,712.0,3218.81
Draftkings,2022-11-20 00:39:00,Wager,,-7.0,705.0,3211.81
Draftkings,2022-11-20 00:58:00,Winnings,,1.92,719.75,3226.56
Draftkings,2022-11-20 00:58:00,Winnings,,12.83,717.83,3224.64
Draftkings,2022-11-20 12:29:00,Winnings,,20.25,775.25,3282.06
Draftkings,2022-11-20 12:29:00,Winnings,,35.25,755.0,3261.81
Fanduel,2022-11-20 12:57:00,Wager,,-5.0,1445.0,3256.81
Fanduel,2022-11-20 12:57:00,Wager,,-5.0,1440.0,3251.81
Fanduel,2022-11-20 12:58:00,Wager,,-4.0,1436.0,3247.81
Draftkings,2022-11-20 15:03:00,Winnings,,20.91,796.16,3288.97
Draftkings,2022-11-20 15:08:00,Winnings,,8.4,806.76,3299.57
Draftkings,2022-11-20 15:08:00,Winnings,,2.2,798.36,3291.17
Draftkings,2022-11-20 15:12:00,Winnings,,6.81,813.57,3306.38
Draftkings,2022-11-20 15:32:00,Wager,,-2.57,811.0,3303.81
Draftkings,2022-11-20 15:34:00,Winnings,,14.7,825.7,3318.51
Draftkings,2022-11-20 15:34:00,Winnings,,7.7,833.4,3326.21
Fanduel,2022-11-20 16:06:00,Winnings,,10.0,1446.0,3336.21
Fanduel,2022-11-20 16:24:00,Wager,,-10.0,1436.0,3326.21
Fanduel,2022-11-20 23:21:00,Winnings,,16.93,1452.93,3343.14
Draftkings,2022-11-20 23:26:00,Wager,,-7.4,826.0,3335.74
Fanduel,2022-11-21 15:45:00,Winnings,Bonus,5.0,1457.93,3340.74
Draftkings,2022-11-21 17:18:00,Wager,,-3.0,823.0,3337.74
Fanduel,2022-11-22 12:50:00,Winnings,Bonus,5.0,1462.93,3342.74
Draftkings,2022-11-24 10:55:00,Wager,,-10.0,813.0,3332.74
Draftkings,2022-11-24 10:59:00,Wager,,-8.0,805.0,3324.74
Fanduel,2022-11-24 11:41:00,Wager,,-5.0,1457.93,3319.74
Fanduel,2022-11-24 11:41:00,Wager,,-5.0,1452.93,3314.74
Fanduel,2022-11-24 11:42:00,Wager,,-7.93,1445.0,3306.81
Fanduel,2022-11-24 11:44:00,Wager,,-2.0,1443.0,3304.81
Fanduel,2022-11-24 11:50:00,Wager,,-15.0,1428.0,3289.81
Fanduel,2022-11-24 11:54:00,Wager,,-5.0,1423.0,3284.81
Draftkings,2022-11-24 17:22:00,Wager,,-5.0,800.0,3279.81
Draftkings,2022-11-24 17:26:00,Wager,,-15.0,785.0,3264.81
Fanduel,2022-11-24 18:26:00,Wager,,-12.0,1411.0,3252.81
Fanduel,2022-11-24 19:35:00,Winnings,,15.86,1426.86,3268.67
Fanduel,2022-11-24 19:56:00,Winnings,,26.38,1453.24,3295.05
Draftkings,2022-11-24 22:24:00,Winnings,,15.67,800.67,3310.72
Draftkings,2022-11-24 22:48:00,Winnings,,18.0,818.67,3328.72
Draftkings,2022-11-24 22:48:00,Winnings,,10.0,828.67,3338.72
Fanduel,2022-11-25 11:55:00,Winnings,Bonus,5.0,1458.24,3343.72
Draftkings,2022-11-25 13:02:00,Wager,,-5.67,823.0,3338.05
Draftkings,2022-11-25 15:10:00,Wager,,-6.0,817.0,3332.05
Fanduel,2022-11-25 15:51:00,Winnings,,26.4,1484.64,3358.45
Draftkings,2022-11-26 00:01:00,Winnings,,5.42,838.92,3380.37
Draftkings,2022-11-26 00:01:00,Winnings,,16.5,833.5,3374.95
Draftkings,2022-11-26 00:44:00,Winnings,,1.88,854.3,3395.75
Draftkings,2022-11-26 00:44:00,Winnings,,13.5,852.42,3393.87
Draftkings,2022-11-26 00:49:00,Wager,,-6.3,848.0,3389.45
Fanduel,2022-11-26 11:45:00,Wager,,-7.64,1472.0,3376.81
Fanduel,2022-11-26 11:45:00,Wager,,-5.0,1479.64,3384.45
Fanduel,2022-11-26 11:51:00,Wager,,-5.0,1467.0,3371.81
Fanduel,2022-11-26 19:34:00,Winnings,,10.55,1477.55,3382.36
Draftkings,2022-11-27 10:03:00,Wager,,-6.0,842.0,3376.36
Draftkings,2022-11-27 10:05:00,Wager,,-4.0,838.0,3372.36
Draftkings,2022-11-27 10:08:00,Wager,,-8.0,830.0,3364.36
Fanduel,2022-11-27 10:56:00,Wager,,-7.55,1470.0,3356.81
Draftkings,2022-11-27 15:04:00,Winnings,,7.8,851.6,3378.41
Draftkings,2022-11-27 15:04:00,Winnings,,13.8,843.8,3370.61
Draftkings,2022-11-27 16:24:00,Winnings,,16.8,868.4,3395.21
Fanduel,2022-11-27 17:51:00,Wager,,-5.0,1465.0,3390.21
Fanduel,2022-11-27 23:34:00,Winnings,,11.25,1476.25,3401.46
Fanduel,2022-11-28 05:30:00,Winnings,Bonus,2.0,1478.25,3403.46
Fanduel,2022-11-28 19:59:00,Wager,,-6.25,1472.0,3397.21
Fanduel,2022-11-28 22:31:00,Winnings,,14.06,1486.06,3411.27
Fanduel,2022-11-29 14:37:00,Winnings,Bonus,10.0,1496.06,3421.27
Draftkings,2022-11-29 15:03:00,Winnings,,18.04,886.44,3439.31
Fanduel,2022-11-29 16:02:00,Winnings,,9.55,1505.61,3448.86
Draftkings,2022-11-29 19:51:00,Wager,,-2.44,884.0,3446.42
Fanduel,2022-11-29 20:47:00,Wager,,-5.0,1500.61,3441.42
Fanduel,2022-11-29 20:48:00,Wager,,-10.0,1490.61,3431.42
Fanduel,2022-11-30 00:57:00,Winnings,Bonus,5.0,1495.61,3436.42
Draftkings,2022-11-30 19:49:00,Wager,,-10.0,874.0,3426.42
Fanduel,2022-11-30 20:50:00,Wager,,-8.61,1487.0,3417.81
Fanduel,2022-11-30 20:56:00,Wager,,-5.0,1482.0,3412.81
Fanduel,2022-11-30 22:34:00,Winnings,,11.0,1493.0,3423.81
Fanduel,2022-11-30 22:43:00,Wager,,-4.0,1485.0,3415.81
Fanduel,2022-11-30 22:43:00,Wager,,-4.0,1489.0,3419.81
Fanduel,2022-12-01 00:30:00,Winnings,Bonus,50.0,1535.0,3465.81
Fanduel,2022-12-01 00:47:00,Wager,,-5.0,1530.0,3460.81
Fanduel,2022-12-01 00:51:00,Wager,,-4.0,1526.0,3456.81
Fanduel,2022-12-01 00:54:00,Wager,,-4.0,1522.0,3452.81
Fanduel,2022-12-01 00:57:00,Wager,,-5.0,1517.0,3447.81
Fanduel,2022-12-01 17:36:00,Wager,,-50.0,1467.0,3397.81
Draftkings,2022-12-01 18:47:00,Wager,,-10.0,864.0,3387.81
Draftkings,2022-12-01 18:51:00,Wager,,-20.0,844.0,3367.81
Draftkings,2022-12-01 19:00:00,Wager,,-4.0,840.0,3363.81
Fanduel,2022-12-01 23:12:00,Winnings,Bonus,5.0,1472.0,3368.81
Fanduel,2022-12-02 13:54:00,Winnings,Bonus,5.0,1477.0,3373.81
Draftkings,2022-12-02 20:21:00,Wager,,-3.0,837.0,3370.81
Fanduel,2022-12-03 11:53:00,Winnings,,21.41,1498.41,3392.22
Draftkings,2022-12-03 12:31:00,Wager,,-7.0,830.0,3385.22
Fanduel,2022-12-03 12:32:00,Winnings,Bonus,5.0,1503.41,3390.22
Fanduel,2022-12-03 13:37:00,Wager,,-5.0,1498.41,3385.22
Fanduel,2022-12-03 13:40:00,Wager,,-5.0,1493.41,3380.22
Draftkings,2022-12-03 22:17:00,Winnings,,2.1,845.46,3395.68
Draftkings,2022-12-03 22:17:00,Winnings,,13.36,843.36,3393.58
Draftkings,2022-12-04 09:46:00,Wager,,-2.46,843.0,3393.22
Fanduel,2022-12-04 10:35:00,Wager,,-5.0,1488.41,3388.22
Fanduel,2022-12-04 10:36:00,Wager,,-5.0,1483.41,3383.22
Fanduel,2022-12-04 10:41:00,Wager,,-2.0,1481.41,3381.22
Draftkings,2022-12-04 15:16:00,Winnings,,1.87,856.37,3394.59
Draftkings,2022-12-04 15:16:00,Winnings,,11.5,854.5,3392.72
Draftkings,2022-12-04 15:20:00,Winnings,,24.54,880.91,3419.13
Fanduel,2022-12-04 16:01:00,Winnings,,59.7,1541.11,3478.83
Draftkings,2022-12-11 11:52:00,Wager,,-6.91,874.0,3471.92
Draftkings,2022-12-11 11:55:00,Wager,,-10.0,864.0,3461.92
Draftkings,2022-12-11 11:56:00,Winnings,,10.0,874.0,3471.92
Draftkings,2022-12-11 11:57:00,Wager,,-10.0,864.0,3461.92
Draftkings,2022-12-11 11:59:00,Wager,,-2.0,858.0,3455.92
Draftkings,2022-12-11 11:59:00,Wager,,-4.0,860.0,3457.92
Fanduel,2022-12-11 12:25:00,Wager,,-14.0,1527.11,3443.92
Draftkings,2022-12-12 18:39:00,Wager,,-10.0,848.0,3431.92
Fanduel,2022-12-12 19:48:00,Wager,,-7.11,1520.0,3424.81
Fanduel,2022-12-13 11:36:00,Winnings,Bonus,5.0,1525.0,3429.81
Draftkings,2022-12-15 20:48:00,Wager,,-4.0,844.0,3425.81
Draftkings,2022-12-15 22:22:00,Winnings,,9.2,853.2,3435.01
Draftkings,2022-12-15 22:22:00,Winnings,,2.6,855.8,3437.61
Draftkings,2022-12-17 12:08:00,Wager,,-10.0,845.8,3427.61
Draftkings,2022-12-17 12:10:00,Wager,,-5.8,840.0,3421.81
Fanduel,2022-12-17 13:04:00,Wager,,-5.0,1520.0,3416.81
Draftkings,2022-12-17 23:06:00,Wager,,-10.0,830.0,3406.81
Draftkings,2022-12-17 23:10:00,Wager,,-15.0,815.0,3391.81
Draftkings,2022-12-18 09:37:00,Wager,,-2.0,813.0,3389.81
Draftkings,2022-12-18 15:43:00,Winnings,,21.5,834.5,3411.31
Fanduel,2022-12-18 16:19:00,Wager,,-5.0,1510.0,3401.31
Fanduel,2022-12-18 16:19:00,Wager,,-5.0,1515.0,3406.31
Draftkings,2022-12-18 17:53:00,Winnings,,3.81,857.0,3428.81
Draftkings,2022-12-18 17:53:00,Winnings,,18.69,853.19,3425.0
Draftkings,2022-12-18 18:33:00,Winnings,,24.28,881.28,3453.09
Draftkings,2022-12-18 19:02:00,Wager,,-15.28,866.0,3437.81
Fanduel,2022-12-18 20:10:00,Winnings,,20.0,1530.0,3452.81
Fanduel,2022-12-18 23:30:00,Winnings,,20.0,1550.0,3472.81
Fanduel,2022-12-19 17:39:00,Wager,,-3.0,1547.0,3469.81
Fanduel,2022-12-19 17:40:00,Wager,,-3.0,1544.0,3466.81
Fanduel,2022-12-19 17:44:00,Wager,,-3.0,1541.0,3463.81
Fanduel,2022-12-19 17:46:00,Wager,,-3.0,1538.0,3460.81
Fanduel,2022-12-19 23:16:00,Winnings,Bonus,3.0,1541.0,3463.81
Fanduel,2022-12-19 23:17:00,Winnings,Bonus,3.0,1544.0,3466.81
Fanduel,2022-12-19 23:17:00,Winnings,Bonus,3.0,1547.0,3469.81
Fanduel,2022-12-19 23:28:00,Winnings,Bonus,3.0,1550.0,3472.81
Draftkings,2022-12-21 18:17:00,Wager,,-4.0,862.0,3468.81
Fanduel,2022-12-21 19:11:00,Wager,,-12.0,1538.0,3456.81
Draftkings,2022-12-23 21:10:00,Wager,,-10.0,852.0,3446.81
Draftkings,2022-12-23 21:14:00,Wager,,-10.0,842.0,3436.81
Draftkings,2022-12-23 21:16:00,Wager,,-10.0,832.0,3426.81
Fanduel,2022-12-23 21:40:00,Wager,,-18.0,1520.0,3408.81
Fanduel,2022-12-24 00:45:00,Wager,,-4.0,1516.0,3404.81
Fanduel,2022-12-24 00:45:00,Wager,,-2.0,1514.0,3402.81
Draftkings,2022-12-24 09:38:00,Wager,,-7.0,825.0,3395.81
Draftkings,2022-12-24 15:37:00,Winnings,,18.9,843.9,3414.71
Draftkings,2022-12-24 15:37:00,Winnings,,3.57,847.47,3418.28
Draftkings,2022-12-25 15:36:00,Wager,,-5.0,842.47,3413.28
Draftkings,2022-12-25 15:38:00,Wager,,-10.0,832.47,3403.28
Draftkings,2022-12-25 18:57:00,Winnings,,23.0,855.47,3426.28
Draftkings,2022-12-25 18:57:00,Winnings,,6.5,861.97,3432.78
Draftkings,2022-12-29 19:17:00,Wager,,-8.0,853.97,3424.78
Draftkings,2022-12-29 19:17:00,Wager,,-8.0,853.97,3424.78
Draftkings,2022-12-29 19:17:00,Wager,,8.0,861.97,3432.78
Draftkings,2022-12-30 21:56:00,Wager,,-6.97,847.0,3417.81
Draftkings,2022-12-30 21:57:00,Wager,,-10.0,837.0,3407.81
Draftkings,2022-12-31 09:59:00,Wager,,-10.0,827.0,3397.81
Draftkings,2022-12-31 10:00:00,Wager,,-10.0,817.0,3387.81
Fanduel,2022-12-31 11:02:00,Wager,,-7.0,1507.0,3380.81
Draftkings,2022-12-31 19:05:00,Winnings,,19.09,836.09,3399.9
Draftkings,2022-12-31 19:11:00,Winnings,,4.54,840.63,3404.44
Draftkings,2022-12-31 20:24:00,Winnings,,22.27,862.9,3426.71
Draftkings,2022-12-31 20:24:00,Winnings,,6.13,869.03,3432.84
Draftkings,2023-01-01 09:32:00,Wager,,-10.0,859.03,3422.84
Draftkings,2023-01-01 09:34:00,Wager,,-2.03,857.0,3420.81
Draftkings,2023-01-01 09:40:00,Wager,,-7.0,850.0,3413.81
Draftkings,2023-01-01 09:43:00,Wager,,-6.0,844.0,3407.81
Fanduel,2023-01-01 10:44:00,Wager,,-7.0,1500.0,3400.81
Fanduel,2023-01-01 10:46:00,Wager,,-10.0,1490.0,3390.81
Draftkings,2023-01-01 11:55:00,Wager,,-5.0,838.0,3384.81
Draftkings,2023-01-01 11:55:00,Wager,,-1.0,843.0,3389.81
Draftkings,2023-01-01 11:56:00,Wager,,-4.0,834.0,3380.81
Draftkings,2023-01-01 11:56:00,Wager,,-4.0,830.0,3376.81
Fanduel,2023-01-01 19:03:00,Winnings,,13.92,1503.92,3390.73
Draftkings,2023-01-03 20:47:00,Wager,,-6.0,824.0,3384.73
Draftkings,2023-01-05 16:02:00,Wager,,-10.0,814.0,3374.73
Draftkings,2023-01-05 16:03:00,Wager,,-5.0,809.0,3369.73
Fanduel,2023-01-05 17:00:00,Wager,,-5.0,1498.92,3364.73
Fanduel,2023-01-05 17:04:00,Wager,,-15.92,1483.0,3348.81
Fanduel,2023-01-05 21:06:00,Winnings,,32.8,1515.8,3381.61
Fanduel,2023-01-05 21:53:00,Winnings,Bonus,5.0,1520.8,3386.61
Draftkings,2023-01-07 09:08:00,Wager,,-6.0,798.0,3375.61
Draftkings,2023-01-07 09:08:00,Wager,,-5.0,804.0,3381.61
Draftkings,2023-01-08 11:54:00,Wager,,-1.0,797.0,3374.61
Fanduel,2023-01-08 12:53:00,Wager,,-5.0,1515.8,3369.61
Fanduel,2023-01-08 12:58:00,Wager,,-5.8,1510.0,3363.81
Fanduel,2023-01-08 17:58:00,Wager,,-10.0,1500.0,3353.81
Draftkings,2023-01-08 21:19:00,Winnings,,8.0,805.0,3361.81
Draftkings,2023-01-08 21:19:00,Winnings,,2.0,807.0,3363.81
Fanduel,2023-01-09 19:33:00,Wager,,-5.0,1495.0,3358.81
Draftkings,2023-01-12 19:03:00,Wager,,-10.0,797.0,3348.81
Fanduel,2023-01-12 20:01:00,Wager,,-5.0,1490.0,3343.81
Fanduel,2023-01-13 00:58:00,Winnings,Bonus,5.0,1495.0,3348.81
Draftkings,2023-01-14 14:40:00,Wager,,-7.0,790.0,3341.81
Draftkings,2023-01-14 14:42:00,Wager,,-10.0,780.0,3331.81
Draftkings,2023-01-14 14:42:00,Wager,,-10.0,770.0,3321.81
Fanduel,2023-01-14 15:47:00,Wager,,-10.0,1485.0,3311.81
Draftkings,2023-01-14 15:59:00,Winnings,,16.89,786.89,3328.7
Draftkings,2023-01-14 16:01:00,Winnings,,3.11,790.0,3331.81
Draftkings,2023-01-14 17:49:00,Winnings,,32.5,822.5,3364.31
Fanduel,2023-01-14 19:56:00,Wager,,-10.0,1475.0,3354.31
Fanduel,2023-01-15 13:00:00,Wager,,-5.0,1470.0,3349.31
Fanduel,2023-01-15 16:19:00,Wager,,-10.0,1460.0,3339.31
Fanduel,2023-01-15 16:23:00,Wager,,-8.0,1452.0,3331.31
Fanduel,2023-01-15 16:24:00,Wager,,-8.0,1444.0,3323.31
Draftkings,2023-01-15 21:56:00,Wager,,-10.0,812.5,3313.31
Draftkings,2023-01-15 22:18:00,Winnings,,18.0,830.5,3331.31
Fanduel,2023-01-15 22:59:00,Wager,,-5.0,1439.0,3326.31
Draftkings,2023-01-16 14:29:00,Wager,,-10.0,820.5,3316.31
Draftkings,2023-01-16 14:32:00,Wager,,-10.0,810.5,3306.31
Draftkings,2023-01-16 14:34:00,Wager,,-10.0,800.5,3296.31
Fanduel,2023-01-16 15:35:00,Wager,,-7.0,1432.0,3289.31
Draftkings,2023-01-16 15:53:00,Winnings,,15.55,816.05,3304.86
Draftkings,2023-01-16 15:53:00,Winnings,,1.83,817.88,3306.69
Fanduel,2023-01-16 19:10:00,Wager,,-12.0,1420.0,3294.69
Fanduel,2023-01-16 22:17:00,Wager,,-5.0,1415.0,3289.69
Fanduel,2023-01-16 22:18:00,Wager,,-3.0,1412.0,3286.69
Fanduel,2023-01-16 22:27:00,Wager,,-3.45,1408.55,3283.24
Draftkings,2023-01-16 22:28:00,Winnings,,16.66,834.54,3299.9
Fanduel,2023-01-16 22:28:00,Wager,,-1.0,1407.55,3298.9
Draftkings,2023-01-16 22:29:00,Winnings,,3.34,837.88,3302.24
Fanduel,2023-01-16 22:35:00,Winnings,,8.45,1416.0,3310.69
Fanduel,2023-01-16 22:50:00,Wager,,-2.55,1413.45,3308.14
Fanduel,2023-01-16 23:41:00,Winnings,,14.0,1427.45,3322.14
Fanduel,2023-01-17 12:19:00,Winnings,Bonus,25.0,1452.45,3347.14
Fanduel,2023-01-19 21:44:00,Wager,,-5.0,1447.45,3342.14
Fanduel,2023-01-20 00:47:00,Winnings,,25.76,1473.21,3367.9
Draftkings,2023-01-21 15:13:00,Wager,,-7.88,830.0,3360.02
Draftkings,2023-01-21 15:13:00,Wager,,7.88,837.88,3367.9
Draftkings,2023-01-21 15:14:00,Wager,,-10.0,827.88,3357.9
Draftkings,2023-01-21 15:16:00,Wager,,-6.88,821.0,3351.02
Fanduel,2023-01-21 16:08:00,Wager,,-5.0,1468.21,3346.02
Fanduel,2023-01-21 16:10:00,Wager,,-7.21,1461.0,3338.81
Draftkings,2023-01-21 17:05:00,Winnings,,3.61,838.71,3356.52
Draftkings,2023-01-21 17:05:00,Winnings,,14.1,835.1,3352.91
Fanduel,2023-01-21 19:37:00,Winnings,,25.82,1486.82,3378.73
Draftkings,2023-01-21 19:46:00,Winnings,,16.66,855.37,3399.0
Draftkings,2023-01-21 19:50:00,Winnings,,3.34,858.71,3402.34
Draftkings,2023-01-22 11:44:00,Wager,,-7.71,851.0,3394.63
Draftkings,2023-01-22 11:47:00,Wager,,-7.0,844.0,3387.63
Draftkings,2023-01-22 11:48:00,Wager,,-10.0,834.0,3377.63
Draftkings,2023-01-22 11:49:00,Wager,,-2.0,832.0,3375.63
Draftkings,2023-01-22 11:50:00,Wager,,-2.0,830.0,3373.63
Fanduel,2023-01-22 12:53:00,Wager,,-25.0,1461.82,3348.63
Fanduel,2023-01-22 12:53:00,Wager,,-4.82,1457.0,3343.81
Draftkings,2023-01-22 14:07:00,Winnings,,4.5,834.5,3348.31
Draftkings,2023-01-22 14:09:00,Winnings,,1.0,835.5,3349.31
Fanduel,2023-01-22 16:06:00,Winnings,,50.0,1507.0,3399.31
Fanduel,2023-01-22 16:09:00,Wager,,-50.0,1457.0,3349.31
Draftkings,2023-01-22 20:47:00,Winnings,,25.0,860.5,3374.31
Fanduel,2023-01-24 20:31:00,Wager,,-2.0,1455.0,3372.31
Fanduel,2023-01-25 01:11:00,Winnings,,4.5,1459.5,3376.81
Draftkings,2023-01-26 00:55:00,Wager,,-14.5,846.0,3362.31
Fanduel,2023-01-26 01:53:00,Wager,,-10.0,1449.5,3352.31
Fanduel,2023-01-26 01:56:00,Winnings,,10.0,1459.5,3362.31
Draftkings,2023-01-26 20:01:00,Wager,,-5.0,841.0,3357.31
Draftkings,2023-01-26 22:16:00,Winnings,,14.5,855.5,3371.81
Draftkings,2023-01-27 13:03:00,Wager,,-10.0,845.5,3361.81
Draftkings,2023-01-27 13:09:00,Wager,,-15.0,830.5,3346.81
Draftkings,2023-01-27 13:10:00,Wager,,-10.0,820.5,3336.81
Fanduel,2023-01-27 14:14:00,Wager,,-4.5,1455.0,3332.31
Fanduel,2023-01-27 21:40:00,Winnings,,6.03,1461.03,3338.34
Draftkings,2023-01-27 21:43:00,Winnings,,44.25,864.75,3382.59
Draftkings,2023-01-27 21:43:00,Winnings,,29.25,894.0,3411.84
Draftkings,2023-01-27 23:20:00,Winnings,,19.71,913.71,3431.55
Draftkings,2023-01-27 23:20:00,Winnings,,4.85,918.56,3436.4
Draftkings,2023-01-28 09:46:00,Wager,,-5.56,913.0,3430.84
Draftkings,2023-01-28 09:51:00,Wager,,-15.0,898.0,3415.84
Draftkings,2023-01-28 09:55:00,Wager,,-11.0,887.0,3404.84
Fanduel,2023-01-28 10:44:00,Wager,,-5.0,1456.03,3399.84
Draftkings,2023-01-28 13:17:00,Wager,,-10.0,877.0,3389.84
Draftkings,2023-01-28 15:08:00,Winnings,,4.35,900.04,3412.88
Draftkings,2023-01-28 15:08:00,Winnings,,18.69,895.69,3408.53
Draftkings,2023-01-28 21:19:00,Winnings,,33.0,933.04,3445.88
Draftkings,2023-01-28 21:21:00,Winnings,,13.5,946.54,3459.38
Fanduel,2023-01-28 21:22:00,Winnings,Bonus,5.0,1461.03,3464.38
Draftkings,2023-01-28 23:06:00,Winnings,,9.14,955.68,3473.52
Draftkings,2023-01-28 23:09:00,Winnings,,1.98,957.66,3475.5
Draftkings,2023-01-29 10:04:00,Wager,,-10.0,947.66,3465.5
Draftkings,2023-01-29 10:05:00,Wager,,-5.66,942.0,3459.84
Draftkings,2023-01-29 10:06:00,Wager,,-2.0,940.0,3457.84
Draftkings,2023-01-29 10:07:00,Wager,,-10.0,930.0,3447.84
Fanduel,2023-01-29 11:10:00,Wager,,-5.0,1456.03,3442.84
Fanduel,2023-01-29 11:13:00,Wager,,-5.0,1451.03,3437.84
Fanduel,2023-01-29 11:16:00,Wager,,-6.03,1445.0,3431.81
Draftkings,2023-01-29 12:22:00,Wager,,-4.0,926.0,3427.81
Draftkings,2023-01-29 15:09:00,Winnings,,9.7,935.7,3437.51
Draftkings,2023-01-29 15:13:00,Winnings,,4.45,940.15,3441.96
Fanduel,2023-01-29 18:08:00,Winnings,,22.39,1467.39,3464.35
Fanduel,2023-01-29 18:11:00,Winnings,Bonus,5.0,1472.39,3469.35
Draftkings,2023-01-29 18:43:00,Winnings,,15.0,955.15,3484.35
Draftkings,2023-01-29 18:44:00,Winnings,,4.0,959.15,3488.35
Draftkings,2023-01-29 20:15:00,Winnings,,15.26,974.41,3503.61
Draftkings,2023-01-29 20:21:00,Winnings,,4.74,979.15,3508.35
Fanduel,2023-01-29 22:23:00,Wager,,-20.0,1452.39,3488.35
Draftkings,2023-01-30 20:53:00,Wager,,-10.0,969.15,3478.35
Draftkings,2023-01-30 20:56:00,Wager,,-6.15,963.0,3472.2
Draftkings,2023-01-31 18:39:00,Wager,,-10.0,953.0,3462.2
Draftkings,2023-01-31 18:39:00,Wager,,-10.0,943.0,3452.2
Draftkings,2023-01-31 19:19:00,Winnings,,14.14,957.14,3466.34
Draftkings,2023-01-31 20:53:00,Winnings,,11.66,968.8,3478.0
Draftkings,2023-01-31 23:52:00,Winnings,,30.5,999.3,3508.5
Draftkings,2023-02-01 18:39:00,Winnings,,22.9,1022.2,3531.4
Draftkings,2023-02-01 19:47:00,Wager,,-10.0,1012.2,3521.4
Draftkings,2023-02-01 19:48:00,Wager,,-10.0,1002.2,3511.4
Draftkings,2023-02-01 20:28:00,Winnings,,17.4,1019.6,3528.8
Draftkings,2023-02-02 19:32:00,Wager,,-10.0,1009.6,3518.8
Draftkings,2023-02-02 19:33:00,Wager,,-11.0,998.6,3507.8
Draftkings,2023-02-02 19:55:00,Winnings,,16.36,1014.96,3524.16
Draftkings,2023-02-04 10:29:00,Wager,,-10.0,1004.96,3514.16
Draftkings,2023-02-04 10:30:00,Wager,,-10.0,994.96,3504.16
Fanduel,2023-02-04 11:36:00,Wager,,-5.0,1447.39,3499.16
Fanduel,2023-02-04 11:38:00,Wager,,-5.0,1442.39,3494.16
Fanduel,2023-02-04 11:40:00,Wager,,-5.0,1435.0,3486.77
Fanduel,2023-02-04 11:40:00,Wager,,-2.39,1440.0,3491.77
Fanduel,2023-02-04 11:41:00,Wager,,-5.0,1430.0,3481.77
Fanduel,2023-02-04 15:34:00,Wager,,-5.0,1425.0,3476.77
Draftkings,2023-02-04 19:32:00,Winnings,,14.87,1009.83,3491.64
Fanduel,2023-02-04 21:33:00,Winnings,Bonus,5.0,1430.0,3496.64
Fanduel,2023-02-04 23:03:00,Winnings,,18.5,1448.5,3515.14
Draftkings,2023-02-07 12:08:00,Wager,,-1.0,1008.83,3514.14
Draftkings,2023-02-07 12:14:00,Wager,,-10.0,998.83,3504.14
Draftkings,2023-02-07 18:58:00,Wager,,-10.0,988.83,3494.14
Fanduel,2023-02-07 20:09:00,Wager,,-50.0,1398.5,3444.14
Fanduel,2023-02-07 20:09:00,Wager,,-50.0,1348.5,3394.14
Fanduel,2023-02-07 20:14:00,Wager,,-1.5,1347.0,3392.64
Fanduel,2023-02-07 20:17:00,Wager,,-5.0,1342.0,3387.64
Draftkings,2023-02-07 23:50:00,Winnings,,2.05,990.88,3389.69
Fanduel,2023-02-08 00:31:00,Winnings,,100.0,1442.0,3489.69
Draftkings,2023-02-08 19:50:00,Wager,,-5.88,985.0,3483.81
Draftkings,2023-02-08 19:53:00,Wager,,-10.0,975.0,3473.81
Fanduel,2023-02-08 20:55:00,Wager,,-5.0,1437.0,3468.81
Draftkings,2023-02-09 17:53:00,Wager,,-6.0,969.0,3462.81
Draftkings,2023-02-09 19:54:00,Wager,,-10.0,959.0,3452.81
Draftkings,2023-02-10 20:06:00,Wager,,-10.0,949.0,3442.81
Draftkings,2023-02-10 20:07:00,Wager,,-3.0,946.0,3439.81
Draftkings,2023-02-10 23:34:00,Winnings,,38.5,984.5,3478.31
Draftkings,2023-02-11 09:58:00,Wager,,-10.0,974.5,3468.31
Draftkings,2023-02-11 10:10:00,Wager,,-8.5,966.0,3459.81
Fanduel,2023-02-11 11:15:00,Wager,,-5.0,1432.0,3454.81
Draftkings,2023-02-12 12:07:00,Wager,,-10.0,956.0,3444.81
Fanduel,2023-02-12 12:57:00,Wager,,-15.0,1417.0,3429.81
Fanduel,2023-02-12 12:57:00,Wager,,-15.0,1402.0,3414.81
Fanduel,2023-02-12 13:11:00,Wager,,-30.0,1372.0,3384.81
Draftkings,2023-02-12 15:40:00,Winnings,,39.5,995.5,3424.31
Draftkings,2023-02-12 21:04:00,Winnings,,10.28,1005.78,3434.59
Draftkings,2023-02-12 21:16:00,Winnings,,24.27,1030.05,3458.86
Fanduel,2023-02-12 22:20:00,Winnings,Bonus,5.0,1377.0,3463.86
Fanduel,2023-02-13 05:45:00,Winnings,Bonus,5.0,1382.0,3468.86
Draftkings,2023-02-13 19:23:00,Wager,,-10.0,1020.05,3458.86
Draftkings,2023-02-13 23:31:00,Winnings,,36.0,1056.05,3494.86
Draftkings,2023-02-14 18:49:00,Wager,,-10.0,1046.05,3484.86
Fanduel,2023-02-14 19:55:00,Wager,,-5.0,1377.0,3479.86
Draftkings,2023-02-15 19:24:00,Wager,,-10.0,1036.05,3469.86
Fanduel,2023-02-15 21:50:00,Wager,,-5.0,1372.0,3464.86
Draftkings,2023-02-15 22:26:00,Winnings,,37.0,1073.05,3501.86
Fanduel,2023-02-16 01:43:00,Wager,,-10.0,1362.0,3491.86
Fanduel,2023-02-16 18:28:00,Wager,,-5.0,1357.0,3486.86
Fanduel,2023-02-16 18:30:00,Wager,,-5.0,1352.0,3481.86
Fanduel,2023-02-16 21:59:00,Winnings,Bonus,5.0,1357.0,3486.86
Draftkings,2023-02-18 12:06:00,Wager,,-15.0,1058.05,3471.86
Fanduel,2023-02-18 13:02:00,Wager,,-10.0,1337.0,3451.86
Fanduel,2023-02-18 13:02:00,Wager,,-10.0,1347.0,3461.86
Draftkings,2023-02-18 15:49:00,Wager,,-11.0,1047.05,3450.86
Draftkings,2023-02-18 17:18:00,Winnings,,4.59,1071.8,3475.61
Draftkings,2023-02-18 17:18:00,Winnings,,20.16,1067.21,3471.02
Fanduel,2023-02-18 23:34:00,Winnings,,21.0,1358.0,3482.02
Draftkings,2023-02-19 11:59:00,Wager,,-6.0,1065.8,3480.61
Fanduel,2023-02-19 13:00:00,Wager,,-5.0,1353.0,3475.61
Draftkings,2023-02-19 13:23:00,Wager,,-10.0,1055.8,3465.61
Draftkings,2023-02-19 14:02:00,Winnings,,4.54,1079.43,3489.24
Draftkings,2023-02-19 14:02:00,Winnings,,19.09,1074.89,3484.7
Draftkings,2023-02-19 14:42:00,Wager,,-10.0,1069.43,3479.24
Draftkings,2023-02-19 21:54:00,Winnings,,22.5,1091.93,3501.74
Draftkings,2023-02-19 21:55:00,Winnings,,3.12,1095.05,3504.86
Draftkings,2023-02-20 19:08:00,Wager,,-3.0,1092.05,3501.86
Draftkings,2023-02-21 19:50:00,Wager,,-10.0,1082.05,3491.86
Draftkings,2023-02-21 19:56:00,Wager,,-4.0,1078.05,3487.86
Draftkings,2023-02-21 22:34:00,Winnings,,11.8,1089.85,3499.66
Fanduel,2023-02-22 18:42:00,Wager,,-1.0,1352.0,3498.66
Fanduel,2023-02-22 23:37:00,Winnings,,3.0,1355.0,3501.66
Draftkings,2023-02-24 20:05:00,Wager,,-10.0,1079.85,3491.66
Draftkings,2023-02-24 23:48:00,Winnings,,36.5,1116.35,3528.16
Draftkings,2023-02-25 18:15:00,Wager,,-10.0,1106.35,3518.16
Draftkings,2023-02-25 20:06:00,Wager,,-5.0,1101.35,3513.16
Draftkings,2023-02-27 08:29:00,Wager,,-10.0,1091.35,3503.16
Draftkings,2023-02-28 10:02:00,Wager,,-10.0,1081.35,3493.16
Draftkings,2023-02-28 21:37:00,Winnings,,35.5,1116.85,3528.66
Draftkings,2023-03-01 12:49:00,Wager,,-10.0,1106.85,3518.66
Draftkings,2023-03-01 12:51:00,Wager,,-10.0,1096.85,3508.66
Draftkings,2023-03-01 20:19:00,Winnings,,16.25,1113.1,3524.91
Draftkings,2023-03-01 20:19:00,Winnings,,3.75,1116.85,3528.66
Draftkings,2023-03-01 20:55:00,Wager,,10.0,1116.85,3528.66
Draftkings,2023-03-01 20:55:00,Wager,,-10.0,1106.85,3518.66
Draftkings,2023-03-01 20:56:00,Wager,,-10.0,1106.85,3518.66
Draftkings,2023-03-02 09:03:00,Wager,,-10.0,1096.85,3508.66
Fanduel,2023-03-02 10:06:00,Wager,,-5.0,1350.0,3503.66
Fanduel,2023-03-02 20:15:00,Wager,,-10.0,1340.0,3493.66
Fanduel,2023-03-02 22:07:00,Winnings,Bonus,5.0,1345.0,3498.66
Draftkings,2023-03-02 22:25:00,Wager,,-10.0,1086.85,3488.66
Fanduel,2023-03-02 23:12:00,Winnings,,15.68,1360.68,3504.34
Fanduel,2023-03-02 23:26:00,Wager,,-5.0,1355.68,3499.34
Draftkings,2023-03-03 00:15:00,Winnings,,16.06,1102.91,3515.4
Draftkings,2023-03-03 00:16:00,Winnings,,2.0,1104.91,3517.4
Draftkings,2023-03-03 12:50:00,Wager,,-15.0,1089.91,3502.4
Draftkings,2023-03-03 15:36:00,Wager,,-10.0,1079.91,3492.4
Fanduel,2023-03-04 00:27:00,Wager,,-10.0,1345.68,3482.4
Fanduel,2023-03-04 00:28:00,Wager,,-10.0,1325.68,3462.4
Fanduel,2023-03-04 00:28:00,Wager,,-10.0,1335.68,3472.4
Draftkings,2023-03-04 19:24:00,Wager,,-10.0,1069.91,3462.4
Draftkings,2023-03-04 19:24:00,Wager,,-7.0,1062.91,3455.4
Draftkings,2023-03-04 21:09:00,Wager,,-10.0,1052.91,3445.4
Fanduel,2023-03-04 22:09:00,Wager,,-50.0,1237.68,3347.4
Fanduel,2023-03-04 22:09:00,Wager,,-37.0,1287.68,3397.4
Fanduel,2023-03-04 22:09:00,Wager,,-1.0,1324.68,3434.4
Fanduel,2023-03-04 22:26:00,Winnings,,21.7,1259.38,3369.1
Fanduel,2023-03-05 00:55:00,Winnings,,150.0,1409.38,3519.1
Fanduel,2023-03-05 01:14:00,Wager,,-6.0,1403.38,3513.1
Fanduel,2023-03-05 01:19:00,Wager,,-7.0,1396.38,3506.1
Draftkings,2023-03-05 14:05:00,Wager,,-10.0,1042.91,3496.1
Fanduel,2023-03-05 15:08:00,Wager,,-10.0,1376.38,3476.1
Fanduel,2023-03-05 15:08:00,Wager,,-10.0,1386.38,3486.1
Draftkings,2023-03-05 18:02:00,Winnings,,19.69,1062.6,3505.79
Fanduel,2023-03-05 22:49:00,Winnings,,30.0,1406.38,3525.79
Draftkings,2023-03-06 15:53:00,Wager,,-10.0,1052.6,3515.79
Fanduel,2023-03-06 17:49:00,Wager,,-6.38,1400.0,3509.41
Fanduel,2023-03-06 21:07:00,Winnings,,22.2,1422.2,3531.61
Draftkings,2023-03-07 20:48:00,Wager,,-10.0,1042.6,3521.61
Fanduel,2023-03-07 21:50:00,Wager,,-7.2,1415.0,3514.41
Draftkings,2023-03-07 23:40:00,Winnings,,41.0,1083.6,3555.41
Draftkings,2023-03-08 09:07:00,Wager,,-2.0,1071.6,3543.41
Draftkings,2023-03-08 09:07:00,Wager,,-10.0,1073.6,3545.41
Draftkings,2023-03-08 18:56:00,Wager,,-10.0,1061.6,3533.41
Fanduel,2023-03-08 19:52:00,Wager,,-5.0,1410.0,3528.41
Draftkings,2023-03-08 21:13:00,Wager,,-10.0,1051.6,3518.41
Draftkings,2023-03-08 22:24:00,Winnings,,20.5,1072.1,3538.91
Draftkings,2023-03-09 10:44:00,Wager,,-10.0,1062.1,3528.91
Fanduel,2023-03-09 11:50:00,Wager,,-6.0,1404.0,3522.91
Fanduel,2023-03-09 11:52:00,Wager,,-5.0,1399.0,3517.91
Draftkings,2023-03-09 15:36:00,Winnings,,24.03,1086.13,3541.94
Draftkings,2023-03-09 19:42:00,Wager,,-5.0,1081.13,3536.94
Draftkings,2023-03-09 21:18:00,Winnings,,33.0,1114.13,3569.94
Fanduel,2023-03-10 00:41:00,Winnings,,25.27,1424.27,3595.21
Draftkings,2023-03-10 12:04:00,Wager,,-3.0,1111.13,3592.21
Fanduel,2023-03-10 12:26:00,Wager,,-8.27,1416.0,3583.94
Draftkings,2023-03-10 13:24:00,Winnings,,14.48,1125.61,3598.42
Draftkings,2023-03-10 13:25:00,Winnings,,1.9,1127.51,3600.32
Draftkings,2023-03-10 13:58:00,Wager,,-15.0,1112.51,3585.32
Draftkings,2023-03-10 14:03:00,Wager,,-10.0,1102.51,3575.32
Draftkings,2023-03-10 14:07:00,Wager,,6.0,1102.51,3575.32
Draftkings,2023-03-10 14:07:00,Wager,,-6.0,1096.51,3569.32
Fanduel,2023-03-10 14:25:00,Winnings,,23.98,1439.98,3593.3
Draftkings,2023-03-10 19:19:00,Wager,,-7.0,1095.51,3592.3
Draftkings,2023-03-10 22:26:00,Wager,,-7.0,1088.51,3585.3
Draftkings,2023-03-10 22:53:00,Winnings,,1.92,1103.26,3600.05
Draftkings,2023-03-10 22:53:00,Winnings,,12.83,1101.34,3598.13
Draftkings,2023-03-11 11:51:00,Wager,,-10.0,1093.26,3590.05
Fanduel,2023-03-11 12:43:00,Wager,,-16.98,1423.0,3573.07
Fanduel,2023-03-11 12:44:00,Wager,,-3.0,1420.0,3570.07
Fanduel,2023-03-11 15:17:00,Wager,,-10.0,1410.0,3560.07
Draftkings,2023-03-11 16:17:00,Winnings,,29.86,1123.12,3589.93
Draftkings,2023-03-11 20:18:00,Winnings,,36.5,1159.62,3626.43
Draftkings,2023-03-11 21:34:00,Wager,,-5.0,1154.62,3621.43
Draftkings,2023-03-11 23:04:00,Winnings,,9.54,1164.16,3630.97
Draftkings,2023-03-12 11:13:00,Wager,,-10.0,1154.16,3620.97
Draftkings,2023-03-12 11:15:00,Wager,,-12.0,1142.16,3608.97
Fanduel,2023-03-12 12:12:00,Wager,,-10.0,1400.0,3598.97
Draftkings,2023-03-12 16:41:00,Winnings,,26.35,1191.93,3648.74
Draftkings,2023-03-12 16:41:00,Winnings,,23.42,1165.58,3622.39
Draftkings,2023-03-12 16:42:00,Winnings,,3.78,1195.71,3652.52
Draftkings,2023-03-12 22:48:00,Winnings,,47.0,1242.71,3699.52
Draftkings,2023-03-13 19:08:00,Wager,,-10.0,1232.71,3689.52
Draftkings,2023-03-14 19:42:00,Wager,,-7.0,1225.71,3682.52
Draftkings,2023-03-14 19:44:00,Wager,,-10.0,1215.71,3672.52
Draftkings,2023-03-14 20:03:00,Winnings,,1.67,1231.04,3687.85
Draftkings,2023-03-14 20:03:00,Winnings,,13.66,1229.37,3686.18
Fanduel,2023-03-14 20:59:00,Wager,,-5.0,1395.0,3681.18
Draftkings,2023-03-15 18:56:00,Wager,,-7.0,1224.04,3675.85
Draftkings,2023-03-15 18:57:00,Wager,,-10.0,1214.04,3665.85
Draftkings,2023-03-15 18:59:00,Wager,,-10.0,1204.04,3655.85
Draftkings,2023-03-15 19:43:00,Winnings,,1.59,1218.99,3670.8
Draftkings,2023-03-15 19:43:00,Winnings,,13.36,1217.4,3669.21
Fanduel,2023-03-15 19:55:00,Wager,,-8.0,1387.0,3661.21
Draftkings,2023-03-16 12:31:00,Wager,,-2.0,1216.99,3660.8
Draftkings,2023-03-16 12:34:00,Wager,,-10.0,1206.99,3650.8
Fanduel,2023-03-16 13:30:00,Wager,,-5.0,1382.0,3645.8
Fanduel,2023-03-16 13:30:00,Wager,,-4.0,1378.0,3641.8
Fanduel,2023-03-16 14:46:00,Winnings,,18.51,1396.51,3660.31
Draftkings,2023-03-16 16:45:00,Winnings,,4.9,1211.89,3665.21
Draftkings,2023-03-16 16:46:00,Winnings,,0.6,1212.49,3665.81
Draftkings,2023-03-16 18:14:00,Wager,,-5.0,1207.49,3660.81
Draftkings,2023-03-16 23:16:00,Winnings,,26.14,1233.63,3686.95
Fanduel,2023-03-17 00:45:00,Winnings,,24.0,1420.51,3710.95
Fanduel,2023-03-17 00:45:00,Winnings,,12.0,1432.51,3722.95
Draftkings,2023-03-17 08:53:00,Wager,,-15.0,1213.63,3702.95
Draftkings,2023-03-17 08:53:00,Wager,,-5.0,1228.63,3717.95
Fanduel,2023-03-17 09:57:00,Wager,,-5.0,1427.51,3712.95
Draftkings,2023-03-17 09:59:00,Wager,,-4.0,1209.63,3693.95
Fanduel,2023-03-17 11:01:00,Wager,,-4.0,1423.51,3689.95
Fanduel,2023-03-17 11:02:00,Wager,,-2.0,1421.51,3687.95
Fanduel,2023-03-17 11:03:00,Wager,,-8.0,1413.51,3679.95
Fanduel,2023-03-17 11:06:00,Wager,,-4.0,1409.51,3675.95
Fanduel,2023-03-17 18:51:00,Wager,,-4.0,1405.51,3671.95
Draftkings,2023-03-17 20:52:00,Winnings,,26.0,1235.63,3697.95
Draftkings,2023-03-17 20:53:00,Winnings,,5.5,1241.13,3703.45
Draftkings,2023-03-17 21:06:00,Winnings,,18.5,1259.63,3721.95
Draftkings,2023-03-17 21:06:00,Winnings,,2.35,1261.98,3724.3
Fanduel,2023-03-17 22:06:00,Winnings,Bonus,2.0,1407.51,3726.3
Fanduel,2023-03-17 22:07:00,Winnings,Bonus,4.0,1411.51,3730.3
Fanduel,2023-03-18 00:04:00,Winnings,Bonus,8.0,1419.51,3738.3
Fanduel,2023-03-18 00:09:00,Winnings,Bonus,4.0,1423.51,3742.3
Draftkings,2023-03-18 13:07:00,Wager,,-5.0,1256.98,3737.3
Draftkings,2023-03-18 13:08:00,Wager,,-10.0,1246.98,3727.3
Draftkings,2023-03-18 13:09:00,Wager,,-10.0,1236.98,3717.3
Draftkings,2023-03-18 13:11:00,Wager,,-6.0,1230.98,3711.3
Fanduel,2023-03-18 14:02:00,Wager,,-5.0,1418.51,3706.3
Fanduel,2023-03-18 14:04:00,Wager,,-3.0,1415.51,3703.3
Fanduel,2023-03-18 14:05:00,Wager,,-5.0,1410.51,3698.3
Draftkings,2023-03-18 14:44:00,Winnings,,8.7,1239.68,3707.0
Draftkings,2023-03-18 14:44:00,Winnings,,1.22,1240.9,3708.22
Draftkings,2023-03-18 16:14:00,Winnings,,21.71,1262.61,3729.93
Draftkings,2023-03-18 17:11:00,Wager,,-0.61,1252.0,3719.32
Draftkings,2023-03-18 17:11:00,Wager,,-10.0,1252.61,3719.93
Fanduel,2023-03-18 18:09:00,Wager,,-18.0,1392.51,3701.93
Fanduel,2023-03-18 18:09:00,Wager,,-32.0,1360.51,3669.93
Fanduel,2023-03-18 18:10:00,Wager,,-6.0,1354.51,3663.93
Fanduel,2023-03-18 18:10:00,Wager,,-10.0,1344.51,3653.93
Fanduel,2023-03-18 20:06:00,Winnings,,60.0,1404.51,3713.93
Fanduel,2023-03-18 20:53:00,Wager,,-5.51,1399.0,3708.42
Fanduel,2023-03-18 21:12:00,Winnings,,0.17,1399.17,3708.59
Draftkings,2023-03-18 21:17:00,Winnings,,20.43,1272.43,3728.41
Draftkings,2023-03-18 21:17:00,Winnings,,4.61,1277.04,3733.02
Fanduel,2023-03-18 22:18:00,Winnings,Bonus,3.0,1402.17,3736.02
Fanduel,2023-03-19 00:19:00,Winnings,Bonus,5.0,1407.17,3741.02
Fanduel,2023-03-19 00:19:00,Winnings,Bonus,5.0,1412.17,3746.02
Draftkings,2023-03-19 10:25:00,Wager,,-6.0,1271.04,3740.02
Fanduel,2023-03-19 11:20:00,Wager,,-13.0,1399.17,3727.02
Fanduel,2023-03-19 14:51:00,Wager,,-7.17,1392.0,3719.85
Fanduel,2023-03-19 14:52:00,Wager,,-5.0,1387.0,3714.85
Fanduel,2023-03-19 14:54:00,Wager,,-5.0,1382.0,3709.85
Fanduel,2023-03-19 14:54:00,Wager,,-4.0,1378.0,3705.85
Draftkings,2023-03-19 18:44:00,Wager,,-6.0,1265.04,3699.85
Draftkings,2023-03-19 18:44:00,Wager,,6.0,1271.04,3705.85
Draftkings,2023-03-19 18:44:00,Wager,,-7.0,1264.04,3698.85
Draftkings,2023-03-19 18:46:00,Wager,,-6.0,1258.04,3692.85
Fanduel,2023-03-19 20:18:00,Winnings,Bonus,5.0,1383.0,3697.85
Fanduel,2023-03-19 21:58:00,Wager,,-6.0,1377.0,3691.85
Fanduel,2023-03-19 22:14:00,Winnings,,12.0,1389.0,3703.85
Draftkings,2023-03-19 23:09:00,Winnings,,20.2,1278.24,3724.05
Fanduel,2023-03-20 00:13:00,Winnings,Bonus,5.0,1394.0,3729.05
Fanduel,2023-03-21 20:36:00,Wager,,-10.0,1384.0,3719.05
Draftkings,2023-03-23 19:42:00,Wager,,-8.0,1270.24,3711.05
Draftkings,2023-03-23 19:44:00,Wager,,-6.0,1264.24,3705.05
Fanduel,2023-03-23 20:41:00,Wager,,-10.0,1374.0,3695.05
Fanduel,2023-03-23 20:50:00,Wager,,-5.0,1369.0,3690.05
Fanduel,2023-03-23 21:11:00,Wager,,-7.0,1362.0,3683.05
Fanduel,2023-03-24 01:09:00,Winnings,,27.5,1389.5,3710.55
Fanduel,2023-03-24 18:39:00,Wager,,-8.0,1381.5,3702.55
Fanduel,2023-03-24 18:42:00,Wager,,-5.0,1376.5,3697.55
Fanduel,2023-03-24 18:44:00,Wager,,-5.0,1371.5,3692.55
Fanduel,2023-03-24 20:55:00,Winnings,,27.77,1399.27,3720.32
Fanduel,2023-03-24 21:29:00,Winnings,Bonus,7.0,1406.27,3727.32
Fanduel,2023-03-25 00:15:00,Winnings,,27.24,1433.51,3754.56
Fanduel,2023-03-25 00:15:00,Winnings,Bonus,8.0,1441.51,3762.56
Fanduel,2023-03-25 18:10:00,Wager,,-5.0,1436.51,3757.56
Fanduel,2023-03-25 18:11:00,Wager,,-7.0,1429.51,3750.56
Fanduel,2023-03-25 18:12:00,Wager,,-3.0,1426.51,3747.56
Fanduel,2023-03-25 18:13:00,Wager,,-5.0,1421.51,3742.56
Fanduel,2023-03-25 18:14:00,Wager,,-15.0,1406.51,3727.56
Fanduel,2023-03-25 20:34:00,Winnings,Bonus,5.0,1411.51,3732.56
Draftkings,2023-03-26 12:56:00,Wager,,-10.0,1254.24,3722.56
Fanduel,2023-03-26 13:55:00,Wager,,-5.0,1406.51,3717.56
Draftkings,2023-03-26 16:39:00,Wager,,-7.0,1247.24,3710.56
Fanduel,2023-03-26 16:39:00,Winnings,Bonus,5.0,1411.51,3715.56
Fanduel,2023-03-26 16:39:00,Winnings,Bonus,7.0,1418.51,3722.56
Draftkings,2023-03-26 18:11:00,Wager,,-6.0,1241.24,3716.56
Fanduel,2023-03-26 19:10:00,Wager,,-12.0,1406.51,3704.56
Fanduel,2023-03-26 19:15:00,Winnings,,12.5,1419.01,3717.06
Draftkings,2023-03-26 19:22:00,Winnings,,4.35,1260.29,3736.11
Draftkings,2023-03-26 19:22:00,Winnings,,14.7,1255.94,3731.76
Fanduel,2023-03-26 19:30:00,Winnings,Bonus,5.0,1424.01,3736.76
Fanduel,2023-03-26 19:30:00,Winnings,Bonus,3.0,1427.01,3739.76
Draftkings,2023-03-26 19:36:00,Winnings,,23.45,1283.74,3767.56
Draftkings,2023-03-26 19:36:00,Winnings,,5.42,1289.16,3772.98
Fanduel,2023-03-27 14:42:00,Wager,,-1.0,1426.01,3771.98
Fanduel,2023-03-27 23:40:00,Winnings,,1.0,1427.01,3772.98
Draftkings,2023-03-29 18:43:00,Wager,,-10.0,1279.16,3762.98
Draftkings,2023-03-29 18:46:00,Wager,,7.0,1279.16,3762.98
Draftkings,2023-03-29 18:46:00,Wager,,-7.0,1272.16,3755.98
Draftkings,2023-03-29 18:47:00,Wager,,-7.0,1272.16,3755.98
Draftkings,2023-03-29 18:47:00,Wager,,-7.0,1272.16,3755.98
Draftkings,2023-03-29 18:47:00,Wager,,7.0,1279.16,3762.98
Draftkings,2023-03-29 18:49:00,Wager,,-10.0,1262.16,3745.98
Fanduel,2023-03-29 21:17:00,Wager,,-8.0,1419.01,3737.98
Draftkings,2023-03-29 21:38:00,Winnings,,34.5,1296.66,3772.48
Fanduel,2023-03-30 13:18:00,Wager,,-5.0,1414.01,3767.48
Fanduel,2023-03-30 16:44:00,Winnings,Bonus,5.0,1419.01,3772.48
Draftkings,2023-03-30 16:49:00,Wager,,-10.0,1286.66,3762.48
Draftkings,2023-03-30 16:50:00,Wager,,-10.0,1276.66,3752.48
Draftkings,2023-03-30 16:51:00,Wager,,-10.0,1266.66,3742.48
Fanduel,2023-03-30 17:47:00,Wager,,-10.0,1409.01,3732.48
Fanduel,2023-03-30 17:47:00,Wager,,-10.0,1399.01,3722.48
Fanduel,2023-03-30 20:01:00,Winnings,,17.6,1416.61,3740.08
Draftkings,2023-03-30 20:47:00,Winnings,,4.29,1286.66,3760.08
Draftkings,2023-03-30 20:47:00,Winnings,,15.71,1282.37,3755.79
Draftkings,2023-03-30 22:05:00,Winnings,,38.0,1324.66,3798.08
Fanduel,2023-03-30 22:07:00,Winnings,,38.0,1454.61,3836.08
Draftkings,2023-03-30 23:03:00,Winnings,,4.45,1344.66,3856.08
Draftkings,2023-03-30 23:03:00,Winnings,,15.55,1340.21,3851.63
Fanduel,2023-03-31 11:50:00,Wager,,-15.61,1439.0,3836.02
Fanduel,2023-03-31 11:54:00,Wager,,-14.0,1425.0,3822.02
Draftkings,2023-03-31 18:44:00,Wager,,-10.0,1334.66,3816.47
Draftkings,2023-03-31 18:44:00,Wager,,-10.0,1324.66,3806.47
Draftkings,2023-03-31 18:45:00,Wager,,-10.0,1314.66,3796.47
Draftkings,2023-03-31 18:48:00,Wager,,-10.0,1304.66,3786.47
Fanduel,2023-03-31 19:51:00,Wager,,-5.0,1420.0,3781.47
Fanduel,2023-03-31 19:51:00,Wager,,-5.0,1415.0,3776.47
Draftkings,2023-03-31 21:48:00,Winnings,,35.0,1339.66,3811.47
Draftkings,2023-03-31 23:15:00,Winnings,,14.34,1354.0,3825.81
Draftkings,2023-03-31 23:15:00,Winnings,,5.66,1359.66,3831.47
Fanduel,2023-03-31 23:53:00,Winnings,,8.0,1423.0,3839.47
Draftkings,2023-04-01 12:02:00,Wager,,-6.0,1353.66,3833.47
Draftkings,2023-04-01 12:04:00,Wager,,-10.0,1343.66,3823.47
Draftkings,2023-04-01 12:06:00,Wager,,-6.0,1337.66,3817.47
Fanduel,2023-04-01 13:10:00,Wager,,-5.0,1413.0,3807.47
Fanduel,2023-04-01 13:10:00,Wager,,-5.0,1418.0,3812.47
Draftkings,2023-04-01 15:53:00,Winnings,,17.4,1355.06,3829.87
Draftkings,2023-04-01 15:53:00,Winnings,,3.42,1358.48,3833.29
Fanduel,2023-04-01 16:58:00,Winnings,,30.57,1443.57,3858.86
Fanduel,2023-04-01 16:59:00,Winnings,Bonus,5.0,1448.57,3863.86
Draftkings,2023-04-01 17:03:00,Winnings,,13.2,1371.68,3877.06
Draftkings,2023-04-01 17:03:00,Winnings,,2.37,1374.05,3879.43
Draftkings,2023-04-01 17:59:00,Winnings,,23.44,1397.49,3902.87
Fanduel,2023-04-01 19:14:00,Wager,,-5.0,1443.57,3897.87
Fanduel,2023-04-01 22:49:00,Winnings,,20.0,1463.57,3917.87
Fanduel,2023-04-02 00:23:00,Winnings,,7.96,1471.53,3925.83
Fanduel,2023-04-02 00:50:00,Winnings,,-7.96,1463.57,3917.87
Fanduel,2023-04-02 00:51:00,Winnings,,15.92,1479.49,3933.79
Draftkings,2023-04-02 09:57:00,Wager,,-5.0,1392.49,3928.79
Fanduel,2023-04-02 12:53:00,Wager,,-10.0,1469.49,3918.79
Fanduel,2023-04-02 13:13:00,Wager,,-25.0,1444.49,3893.79
Fanduel,2023-04-02 13:24:00,Wager,,-25.0,1419.49,3868.79
Fanduel,2023-04-02 13:27:00,Wager,,-25.0,1394.49,3843.79
Fanduel,2023-04-02 13:28:00,Wager,,-4.49,1390.0,3839.3
Draftkings,2023-04-02 15:55:00,Winnings,,19.0,1411.49,3858.3
Draftkings,2023-04-02 15:55:00,Winnings,,4.2,1415.69,3862.5
Draftkings,2023-04-02 16:01:00,Wager,,-10.0,1405.69,3852.5
Draftkings,2023-04-02 16:03:00,Wager,,-5.69,1400.0,3846.81
Fanduel,2023-04-02 16:47:00,Winnings,,9.75,1399.75,3856.56
Fanduel,2023-04-02 18:40:00,Winnings,,119.0,1518.75,3975.56
Draftkings,2023-04-02 20:34:00,Winnings,,18.34,1418.34,3993.9
Draftkings,2023-04-02 20:35:00,Winnings,,4.17,1422.51,3998.07
Fanduel,2023-04-02 21:33:00,Winnings,,104.0,1622.75,4102.07
Fanduel,2023-04-02 21:36:00,Winnings,,25.0,1647.75,4127.07
Draftkings,2023-04-03 13:23:00,Wager,,-5.0,1417.51,4122.07
Fanduel,2023-04-03 14:27:00,Wager,,-10.0,1637.75,4112.07
Fanduel,2023-04-03 14:35:00,Wager,,-25.0,1612.75,4087.07
Fanduel,2023-04-03 14:35:00,Winnings,,10.0,1622.75,4097.07
Fanduel,2023-04-03 14:36:00,Wager,,-8.0,1614.75,4089.07
Fanduel,2023-04-03 14:37:00,Wager,,-3.75,1611.0,4085.32
Fanduel,2023-04-03 19:46:00,Wager,,-15.0,1596.0,4070.32
Fanduel,2023-04-03 23:46:00,Winnings,,37.5,1633.5,4107.82
Draftkings,2023-04-04 18:43:00,Wager,,-6.0,1411.51,4101.82
Draftkings,2023-04-04 18:46:00,Wager,,-7.0,1404.51,4094.82
Fanduel,2023-04-05 13:00:00,Wager,,-13.5,1620.0,4081.32
Draftkings,2023-04-05 19:48:00,Wager,,-10.0,1394.51,4071.32
Draftkings,2023-04-05 19:52:00,Wager,,7.0,1394.51,4071.32
Draftkings,2023-04-05 19:52:00,Wager,,-7.0,1387.51,4064.32
Draftkings,2023-04-05 19:53:00,Wager,,7.0,1394.51,4071.32
Draftkings,2023-04-05 19:53:00,Wager,,-7.0,1387.51,4064.32
Draftkings,2023-04-05 19:54:00,Wager,,-7.0,1387.51,4064.32
Draftkings,2023-04-05 19:56:00,Wager,,-3.0,1384.51,4061.32
Draftkings,2023-04-05 19:58:00,Wager,,-7.0,1377.51,4054.32
Draftkings,2023-04-05 20:00:00,Winnings,,22.5,1400.01,4076.82
Draftkings,2023-04-05 23:34:00,Winnings,,8.7,1408.71,4085.52
Draftkings,2023-04-05 23:34:00,Winnings,,3.3,1412.01,4088.82
Draftkings,2023-04-06 00:34:00,Wager,,-5.0,1407.01,4083.82
Draftkings,2023-04-06 00:35:00,Wager,,-1.0,1406.01,4082.82
Fanduel,2023-04-06 01:38:00,Wager,,-15.0,1605.0,4067.82
Fanduel,2023-04-06 01:42:00,Wager,,-13.0,1579.0,4041.82
Fanduel,2023-04-06 01:42:00,Wager,,-13.0,1592.0,4054.82
Draftkings,2023-04-06 20:25:00,Wager,,-7.0,1399.01,4047.82
Draftkings,2023-04-06 20:26:00,Wager,,-2.0,1397.01,4045.82
Draftkings,2023-04-06 20:27:00,Wager,,-3.0,1394.01,4042.82
Draftkings,2023-04-06 21:43:00,Winnings,,27.54,1421.55,4070.36
Draftkings,2023-04-06 21:43:00,Winnings,,6.78,1428.33,4077.14
Draftkings,2023-04-07 10:48:00,Wager,,-5.0,1423.33,4072.14
Draftkings,2023-04-07 11:29:00,Wager,,-7.0,1416.33,4065.14
Fanduel,2023-04-07 11:52:00,Wager,,-15.0,1564.0,4037.14
Fanduel,2023-04-07 11:54:00,Wager,,-15.0,1549.0,4022.14
Draftkings,2023-04-07 21:20:00,Wager,,-4.0,1412.33,4018.14
Fanduel,2023-04-07 22:26:00,Winnings,,58.2,1607.2,4076.34
Draftkings,2023-04-07 23:53:00,Winnings,,13.8,1426.13,4090.14
Draftkings,2023-04-07 23:53:00,Winnings,,2.45,1428.58,4092.59
Draftkings,2023-04-08 09:50:00,Winnings,,0.85,1439.19,4103.2
Draftkings,2023-04-08 09:50:00,Winnings,,9.76,1438.34,4102.35
Draftkings,2023-04-08 09:51:00,Wager,,-7.0,1432.19,4096.2
Draftkings,2023-04-08 10:10:00,Wager,,-20.0,1405.19,4069.2
Draftkings,2023-04-08 10:10:00,Wager,,-7.0,1425.19,4089.2
Fanduel,2023-04-08 10:52:00,Winnings,,32.5,1639.7,4121.7
Fanduel,2023-04-08 11:11:00,Wager,,-50.0,1589.7,4071.7
Fanduel,2023-04-08 11:11:00,Wager,,-6.0,1583.7,4065.7
Fanduel,2023-04-08 11:11:00,Wager,,-0.7,1583.0,4065.0
Draftkings,2023-04-08 16:22:00,Wager,,-5.0,1400.19,4040.0
Fanduel,2023-04-09 00:54:00,Winnings,,110.0,1693.0,4150.0
Draftkings,2023-04-09 09:29:00,Wager,,-7.0,1393.19,4143.0
Draftkings,2023-04-09 09:33:00,Wager,,-7.0,1386.19,4136.0
Draftkings,2023-04-09 15:01:00,Wager,,-3.0,1383.19,4133.0
Draftkings,2023-04-09 15:03:00,Wager,,-6.0,1377.19,4127.0
Draftkings,2023-04-09 17:09:00,Winnings,,5.58,1406.68,4156.49
Draftkings,2023-04-09 17:09:00,Winnings,,23.91,1401.1,4150.91
Draftkings,2023-04-09 18:25:00,Winnings,,10.8,1417.48,4167.29
Draftkings,2023-04-09 18:26:00,Winnings,,0.86,1418.34,4168.15
Fanduel,2023-04-09 20:08:00,Winnings,,25.35,1718.35,4193.5
